MODE 0
BALL 50
STARS 0/400/800
12,0,2 3,30,1 1,30,1 1,30,1 0,0,0 3,30,1 1,30,1 1,30,1 12,0,2
12,0,2 0,0,0 1,30,1 1,30,1 0,0,0 0,0,0 1,30,1 1,30,1 12,0,2
12,0,2 0,0,0 1,30,1 1,30,1 0,0,0 0,0,0 1,30,1 1,30,1 12,0,2
12,0,2 0,0,0 1,30,1 1,30,1 0,0,0 0,0,0 1,30,1 1,30,1 12,0,2
0,0,0 0,0,0 1,30,1 1,30,1 0,0,0 0,0,0 1,30,1 1,30,1 0,0,0
0,0,0 0,0,0 1,30,1 1,30,1 0,0,0 0,0,0 1,30,1 1,30,1 0,0,0
0,0,0 0,0,0 0,0,0 0,0,0 0,0,0 0,0,0 0,0,0 0,0,0 0,0,0
0,0,0 0,0,0 0,0,0 0,0,0 0,0,0 0,0,0 0,0,0 0,0,0 0,0,0
0,0,0 0,0,0 0,0,0 0,0,0 0,0,0 0,0,0 0,0,0 0,0,0 0,0,0