MODE 0
BALL 50
STARS 0/400/1000
0,0,0 0,0,0 0,0,0 0,0,0 0,0,0 0,0,0 0,0,0 0,0,0 0,0,0
0,0,0 0,0,0 1,40,1 3,10,1 1,10,1 2,10,1 1,40,1 0,0,0 0,0,0
0,0,0 12,0,2 1,40,1 1,10,1 0,0,0 1,10,1 1,40,1 12,0,2 0,0,0
0,0,0 0,0,0 1,40,1 1,10,1 0,0,0 1,10,1 1,40,1 0,0,0 0,0,0
0,0,0 0,0,0 1,40,1 1,10,1 0,0,0 1,10,1 1,40,1 0,0,0 0,0,0
12,0,2 1,40,1 1,40,1 5,40,1 1,40,1 4,40,1 1,40,1 1,40,1 12,0,2
0,0,0 0,0,0 0,0,0 0,0,0 0,0,0 0,0,0 0,0,0 0,0,0 0,0,0
0,0,0 0,0,0 0,0,0 0,0,0 0,0,0 0,0,0 0,0,0 0,0,0 0,0,0
0,0,0 0,0,0 0,0,0 0,0,0 0,0,0 0,0,0 0,0,0 0,0,0 0,0,0