MODE 0
BALL 50
STARS 0/400/700
1,50,1 1,50,1 1,50,1 1,50,1 1,50,1 1,50,1 1,50,1 1,50,1 1,50,1
1,50,1 6,50,1 1,50,1 1,50,1 6,50,1 1,50,1 1,50,1 6,50,1 1,50,1
0,0,0 0,0,0 0,0,0 0,0,0 0,0,0 0,0,0 0,0,0 0,0,0 0,0,0
0,0,0 0,0,0 0,0,0 0,0,0 0,0,0 0,0,0 0,0,0 0,0,0 0,0,0
1,30,1 1,50,1 6,50,1 1,50,1 1,50,1 6,50,1 1,50,1 1,50,1 0,0,0
1,30,1 1,50,1 1,50,1 1,50,1 1,50,1 1,50,1 1,50,1 1,50,1 0,0,0
0,0,0 0,0,0 0,0,0 0,0,0 0,0,0 0,0,0 0,0,0 0,0,0 0,0,0
0,0,0 0,0,0 0,0,0 0,0,0 0,0,0 0,0,0 0,0,0 0,0,0 0,0,0
0,0,0 0,0,0 0,0,0 0,0,0 0,0,0 0,0,0 0,0,0 0,0,0 0,0,0