MODE 0
BALL 50
STARS 0/400/800
0,0,0 1,40,1 2,40,1 5,40,1 1,40,1 1,40,1 4,40,1 3,40,1 1,40,1
0,0,0 1,40,1 1,40,1 2,40,1 5,40,1 4,40,1 3,40,1 1,40,1 1,40,1
0,0,0 1,40,1 6,40,1 1,40,1 12,0,2 12,0,2 1,40,1 6,40,1 1,40,1
0,0,0 1,40,1 1,40,1 4,40,1 3,40,1 2,40,1 5,40,1 1,40,1 1,40,1
0,0,0 0,0,0 0,0,0 3,40,1 1,40,1 1,40,1 2,40,1 5,40,1 1,40,1
1,80,1 1,80,1 1,80,1 1,60,1 1,60,1 1,60,1 1,60,1 2,60,1 0,0,0
0,0,0 0,0,0 0,0,0 0,0,0 0,0,0 0,0,0 0,0,0 0,0,0 0,0,0
0,0,0 0,0,0 0,0,0 0,0,0 0,0,0 0,0,0 0,0,0 0,0,0 0,0,0
0,0,0 0,0,0 0,0,0 0,0,0 0,0,0 0,0,0 0,0,0 0,0,0 0,0,0