MODE 0
BALL 50
STARS 0/400/800
0,0,0 2,30,1 0,0,0 0,0,0 0,0,0 0,0,0 0,0,0 3,30,1 0,0,0
0,0,0 1,50,1 2,50,1 12,0,2 0,0,0 12,0,2 3,50,1 1,50,1 0,0,0
0,0,0 1,50,1 6,50,1 1,30,1 1,10,1 1,30,1 6,50,1 1,50,1 0,0,0
0,0,0 1,50,1 0,0,0 1,30,1 1,10,1 1,30,1 0,0,0 1,50,1 0,0,0
0,0,0 1,50,1 0,0,0 1,30,1 1,10,1 1,30,1 0,0,0 1,50,1 0,0,0
0,0,0 1,50,1 6,50,1 1,50,1 1,10,1 1,50,1 6,50,1 1,50,1 0,0,0
0,0,0 0,0,0 1,10,1 1,10,1 1,10,1 1,10,1 1,10,1 0,0,0 0,0,0
0,0,0 0,0,0 0,0,0 0,0,0 0,0,0 0,0,0 0,0,0 0,0,0 0,0,0
0,0,0 0,0,0 0,0,0 0,0,0 0,0,0 0,0,0 0,0,0 0,0,0 0,0,0