MODE 0
BALL 50
STARS 0/400/800
0,0,0 0,0,0 3,50,1 1,50,1 1,70,1 1,70,1 1,70,1 1,50,1 1,50,1
0,0,0 0,0,0 5,50,1 4,70,1 0,0,0 0,0,0 0,0,0 5,70,1 1,50,1
2,50,1 0,0,0 0,0,0 0,0,0 3,70,1 1,70,1 2,70,1 0,0,0 1,50,1
6,50,1 0,0,0 12,0,2 0,0,0 1,70,1 1,70,1 1,70,1 12,0,2 1,50,1
4,50,1 0,0,0 0,0,0 0,0,0 5,70,1 1,70,1 4,70,1 0,0,0 1,50,1
0,0,0 3,50,1 6,50,1 2,70,1 0,0,0 0,0,0 0,0,0 3,70,1 1,50,1
0,0,0 5,50,1 1,50,1 1,50,1 1,70,1 1,70,1 1,70,1 1,50,1 1,50,1
0,0,0 0,0,0 0,0,0 0,0,0 0,0,0 0,0,0 0,0,0 0,0,0 0,0,0
0,0,0 0,0,0 0,0,0 0,0,0 0,0,0 0,0,0 0,0,0 0,0,0 0,0,0