MODE 0
BALL 50
STARS 0/400/800
1,50,1 1,50,1 1,50,1 1,50,1 1,50,1 1,50,1 4,50,1 10,0,2 3,50,1
1,50,1 1,50,1 1,50,1 1,50,1 1,50,1 4,50,1 0,0,0 3,50,1 1,50,1
1,50,1 1,50,1 1,50,1 1,50,1 4,50,1 10,0,2 3,50,1 1,50,1 1,50,1
1,50,1 1,50,1 1,50,1 4,50,1 0,0,0 3,50,1 1,50,1 1,50,1 1,50,1
1,50,1 1,50,1 4,50,1 10,0,2 3,50,1 1,50,1 1,50,1 1,50,1 1,50,1
0,0,0 0,0,0 0,0,0 0,0,0 0,0,0 0,0,0 0,0,0 0,0,0 0,0,0
0,0,0 0,0,0 0,0,0 0,0,0 0,0,0 0,0,0 0,0,0 0,0,0 0,0,0
0,0,0 0,0,0 0,0,0 0,0,0 0,0,0 0,0,0 0,0,0 0,0,0 0,0,0
0,0,0 0,0,0 0,0,0 0,0,0 0,0,0 0,0,0 0,0,0 0,0,0 0,0,0