MODE 0
BALL 50
STARS 0/50/70
1,40,1 1,40,1 1,40,1 1,40,1 1,40,1 1,40,1 1,40,1 1,40,1 1,40,1
1,50,1 0,0,0 12,0,2 0,0,0 12,0,2 0,0,0 12,0,2 0,0,0 1,50,1
1,50,1 0,0,0 0,0,0 0,0,0 0,0,0 0,0,0 0,0,0 0,0,0 1,50,1
1,50,1 0,0,0 0,0,0 12,0,2 0,0,0 12,0,2 0,0,0 0,0,0 1,50,1
1,50,1 1,50,1 1,50,1 1,50,1 1,50,1 1,50,1 1,50,1 2,50,1 0,0,0
0,0,0 0,0,0 0,0,0 0,0,0 0,0,0 0,0,0 0,0,0 0,0,0 0,0,0
0,0,0 0,0,0 0,0,0 0,0,0 0,0,0 0,0,0 0,0,0 0,0,0 0,0,0
0,0,0 0,0,0 0,0,0 0,0,0 0,0,0 0,0,0 0,0,0 0,0,0 0,0,0
0,0,0 0,0,0 0,0,0 0,0,0 0,0,0 0,0,0 0,0,0 0,0,0 0,0,0