MODE 0
BALL 50
STARS 0/0/1925 35
ADDLINE 0,0,0 0,0,0 12,0,2 0,0,0 12,0,2 0,0,0 12,0,2 0,0,0 0,0,0
ADDLINE 8,0,2 1,47,1 1,47,1 1,47,1 1,47,1 1,47,1 1,47,1 1,47,1 1,47,1
ADDLINE 8,0,2 1,37,1 1,37,1 1,37,1 1,37,1 1,37,1 1,37,1 1,37,1 1,37,1
1,86,1 1,86,1 1,86,1 1,86,1 1,86,1 1,86,1 1,86,1 1,86,1 0,0,0
0,0,0 0,0,0 7,0,2 0,0,0 7,0,2 0,0,0 7,0,2 0,0,0 7,0,2
12,0,2 1,52,1 1,52,1 1,52,1 1,52,1 1,52,1 1,52,1 1,52,1 1,52,1
12,0,2 1,53,1 1,53,1 1,53,1 1,53,1 1,53,1 1,53,1 1,53,1 1,53,1
12,0,2 1,53,1 1,53,1 1,53,1 1,53,1 1,53,1 1,53,1 1,53,1 1,53,1
0,0,0 7,0,2 0,0,0 7,0,2 0,0,0 7,0,2 0,0,0 7,0,2 0,0,0
1,84,1 1,84,1 1,84,1 1,84,1 1,84,1 1,84,1 1,84,1 0,0,0 12,0,2
0,0,0 0,0,0 0,0,0 0,0,0 0,0,0 0,0,0 0,0,0 0,0,0 0,0,0
0,0,0 0,0,0 0,0,0 0,0,0 0,0,0 0,0,0 0,0,0 0,0,0 0,0,0