MODE 0
BALL 50
STARS 0/0/1820 35
ADDLINE 1,47,1 1,47,1 0,0,0 0,0,0 12,0,2 0,0,0 0,0,0 1,47,1 1,47,1
ADDLINE 1,45,1 1,45,1 0,0,0 1,45,1 12,0,2 1,45,1 0,0,0 1,45,1 1,45,1
ADDLINE 1,37,1 1,37,1 0,0,0 1,37,1 12,0,2 1,37,1 0,0,0 1,37,1 1,37,1
4,46,1 0,0,0 12,0,2 0,0,0 12,0,2 0,0,0 12,0,2 0,0,0 5,46,1
0,0,0 3,45,1 1,45,1 2,45,1 12,0,2 3,45,1 1,45,1 2,45,1 0,0,0
12,0,2 1,44,1 1,44,1 1,44,1 6,44,1 1,44,1 1,44,1 1,44,1 12,0,2
0,0,0 1,43,1 10,0,2 1,43,1 1,43,1 1,43,1 10,0,2 1,43,1 0,0,0
0,0,0 1,44,1 1,44,1 1,44,1 6,44,1 1,44,1 1,44,1 1,44,1 0,0,0
2,42,1 5,42,1 1,42,1 1,42,1 1,42,1 1,42,1 1,42,1 4,42,1 3,42,1
0,0,0 0,0,0 0,0,0 0,0,0 0,0,0 0,0,0 0,0,0 0,0,0 0,0,0
0,0,0 0,0,0 0,0,0 0,0,0 0,0,0 0,0,0 0,0,0 0,0,0 0,0,0
0,0,0 0,0,0 0,0,0 0,0,0 0,0,0 0,0,0 0,0,0 0,0,0 0,0,0