MODE 0
BALL 50
STARS 0/0/1855 35
ADDLINE 0,0,0 1,47,1 0,0,0 1,47,1 0,0,0 1,47,1 0,0,0 1,47,1 0,0,0
ADDLINE 1,46,1 1,46,1 12,0,2 1,46,1 6,46,1 1,46,1 12,0,2 1,46,1 1,46,1
ADDLINE 0,0,0 1,38,1 0,0,0 1,38,1 1,38,1 1,38,1 0,0,0 1,38,1 0,0,0
1,67,1 1,67,1 1,67,1 1,67,1 1,67,1 1,67,1 1,67,1 1,67,1 1,67,1
1,66,1 6,66,1 1,66,1 1,66,1 6,66,1 1,66,1 1,66,1 6,66,1 1,66,1
0,0,0 0,0,0 12,0,2 0,0,0 12,0,2 0,0,0 12,0,2 0,0,0 0,0,0
12,0,2 0,0,0 1,53,1 1,53,1 1,53,1 1,53,1 1,53,1 0,0,0 12,0,2
0,0,0 0,0,0 9,0,2 0,0,0 0,0,0 0,0,0 9,0,2 0,0,0 0,0,0
0,0,0 1,52,1 1,52,1 1,52,1 1,52,1 1,52,1 1,52,1 1,52,1 0,0,0
0,0,0 1,42,1 1,42,1 1,42,1 1,42,1 1,42,1 1,42,1 1,42,1 0,0,0
0,0,0 0,0,0 0,0,0 0,0,0 0,0,0 0,0,0 0,0,0 0,0,0 0,0,0
0,0,0 0,0,0 0,0,0 0,0,0 0,0,0 0,0,0 0,0,0 0,0,0 0,0,0