MODE 0
BALL 50
STARS 0/0/1645 35
ADDLINE 7,0,2 0,0,0 1,43,1 1,43,1 1,43,1 1,43,1 1,43,1 0,0,0 7,0,2
ADDLINE 1,46,1 0,0,0 1,46,1 0,0,0 1,46,1 12,0,2 1,46,1 0,0,0 1,46,1
ADDLINE 1,36,1 0,0,0 1,36,1 12,0,2 8,0,2 0,0,0 1,36,1 0,0,0 1,36,1
1,44,1 0,0,0 1,64,1 1,64,1 6,64,1 1,64,1 1,64,1 0,0,0 1,44,1
1,43,1 12,0,2 0,0,0 0,0,0 1,63,1 0,0,0 0,0,0 12,0,2 1,43,1
1,43,1 0,0,0 1,63,1 0,0,0 1,63,1 0,0,0 1,63,1 0,0,0 1,43,1
1,42,1 12,0,2 1,62,1 0,0,0 1,62,1 0,0,0 1,62,1 12,0,2 1,42,1
1,42,1 0,0,0 1,62,1 0,0,0 10,0,2 0,0,0 1,62,1 0,0,0 1,42,1
1,41,1 12,0,2 1,41,1 1,41,1 1,41,1 1,41,1 1,41,1 12,0,2 1,41,1
0,0,0 0,0,0 0,0,0 0,0,0 0,0,0 0,0,0 0,0,0 0,0,0 0,0,0
0,0,0 0,0,0 0,0,0 0,0,0 0,0,0 0,0,0 0,0,0 0,0,0 0,0,0
0,0,0 0,0,0 0,0,0 0,0,0 0,0,0 0,0,0 0,0,0 0,0,0 0,0,0