MODE 0
BALL 50
STARS 0/0/1960 35
ADDLINE 1,47,1 1,47,1 1,47,1 1,47,1 12,0,2 0,0,0 0,0,0 0,0,0 0,0,0
ADDLINE 1,47,1 6,47,1 1,47,1 1,47,1 12,0,2 1,47,1 1,47,1 1,47,1 8,0,2
ADDLINE 1,37,1 1,47,1 1,47,1 1,37,1 12,0,2 0,0,0 0,0,0 0,0,0 0,0,0
1,86,1 1,86,1 1,86,1 1,86,1 0,0,0 3,46,1 2,46,1 0,0,0 0,0,0
1,85,1 6,85,1 1,85,1 4,85,1 3,45,1 1,45,1 1,45,1 2,45,1 8,0,2
1,84,1 1,84,1 4,84,1 3,44,1 1,44,1 1,44,1 1,44,1 1,44,1 12,0,2
1,81,1 4,81,1 3,41,1 1,41,1 1,41,1 1,41,1 1,41,1 1,41,1 8,0,2
4,81,1 3,41,1 1,41,1 12,0,2 0,0,0 12,0,2 0,0,0 0,0,0 12,0,2
0,0,0 1,62,1 1,62,1 1,62,1 1,62,1 1,62,1 1,62,1 1,62,1 1,62,1
0,0,0 0,0,0 0,0,0 0,0,0 0,0,0 0,0,0 0,0,0 0,0,0 0,0,0
0,0,0 0,0,0 0,0,0 0,0,0 0,0,0 0,0,0 0,0,0 0,0,0 0,0,0
0,0,0 0,0,0 0,0,0 0,0,0 0,0,0 0,0,0 0,0,0 0,0,0 0,0,0