MODE 0
BALL 50
STARS 0/0/1750 35
ADDLINE 1,47,1 2,47,1 12,0,2 0,0,0 0,0,0 4,47,1 1,47,1 1,47,1 5,47,1
ADDLINE 1,45,1 12,0,2 5,45,1 4,45,1 0,0,0 1,45,1 2,45,1 1,45,1 1,45,1
ADDLINE 0,0,0 1,37,1 1,37,1 0,0,0 1,37,1 0,0,0 5,37,1 12,0,2 3,37,1
0,0,0 0,0,0 0,0,0 3,1,1 0,0,0 0,0,0 0,0,0 0,0,0 0,0,0
0,0,0 0,0,0 3,65,1 1,105,1 1,105,1 1,105,1 1,65,1 1,105,1 1,105,1
8,0,2 3,44,1 1,44,1 1,44,1 6,44,1 1,44,1 1,44,1 1,44,1 6,44,1
8,0,2 5,43,1 6,43,1 1,43,1 1,43,1 1,43,1 6,43,1 1,43,1 1,43,1
0,0,0 0,0,0 5,65,1 1,65,1 1,45,1 1,65,1 1,65,1 1,65,1 1,45,1
0,0,0 0,0,0 0,0,0 5,1,1 0,0,0 0,0,0 0,0,0 0,0,0 0,0,0
0,0,0 0,0,0 0,0,0 0,0,0 0,0,0 0,0,0 0,0,0 0,0,0 0,0,0
0,0,0 0,0,0 0,0,0 0,0,0 0,0,0 0,0,0 0,0,0 0,0,0 0,0,0
0,0,0 0,0,0 0,0,0 0,0,0 0,0,0 0,0,0 0,0,0 0,0,0 0,0,0