MODE 0
BALL 50
STARS 0/0/2205 35
ADDLINE 0,0,0 1,47,1 12,0,2 5,47,1 0,0,0 1,47,1 0,0,0 0,0,0 0,0,0
ADDLINE 0,0,0 1,47,1 12,0,2 1,47,1 1,47,1 0,0,0 0,0,0 1,47,1 1,47,1
ADDLINE 0,0,0 3,37,1 12,0,2 1,37,1 8,0,2 0,0,0 1,37,1 1,37,1 1,37,1
1,86,1 1,86,1 1,86,1 1,76,1 1,66,1 1,66,1 1,66,1 1,56,1 1,56,1
1,1,1 1,1,1 1,1,1 1,1,1 1,1,1 1,1,1 1,1,1 1,1,1 10,0,2
1,1,1 1,84,1 10,0,2 1,1,1 1,1,1 1,1,1 1,1,1 1,1,1 1,54,1
1,1,1 1,83,1 1,83,1 1,73,1 10,0,2 1,1,1 1,1,1 1,53,1 1,53,1
1,1,1 1,82,1 1,82,1 1,72,1 1,64,1 1,62,1 10,0,2 1,52,1 1,52,1
1,1,1 1,60,1 1,60,1 1,60,1 1,60,1 1,60,1 1,60,1 1,60,1 1,60,1
0,0,0 0,0,0 0,0,0 0,0,0 0,0,0 0,0,0 0,0,0 0,0,0 0,0,0
0,0,0 0,0,0 0,0,0 0,0,0 0,0,0 0,0,0 0,0,0 0,0,0 0,0,0
0,0,0 0,0,0 0,0,0 0,0,0 0,0,0 0,0,0 0,0,0 0,0,0 0,0,0