MODE 0
BALL 50
STARS 0/0/2835 35
ADDLINE 4,46,1 3,46,1 1,46,1 4,46,1 3,46,1 1,46,1 4,46,1 3,46,1 1,46,1
ADDLINE 1,44,1 4,44,1 3,44,1 6,44,1 4,44,1 3,44,1 6,44,1 4,44,1 3,44,1
ADDLINE 3,37,1 1,37,1 4,37,1 3,37,1 1,37,1 4,37,1 3,37,1 1,37,1 4,37,1
3,44,1 1,44,1 4,44,1 3,44,1 1,44,1 4,44,1 3,44,1 1,44,1 0,0,0
1,48,1 4,48,1 3,48,1 1,48,1 4,48,1 3,48,1 1,48,1 4,48,1 3,48,1
4,48,1 3,48,1 1,48,1 4,48,1 3,48,1 1,48,1 4,48,1 3,48,1 1,48,1
3,46,1 6,46,1 4,46,1 3,46,1 6,46,1 4,46,1 3,46,1 6,46,1 4,46,1
1,44,1 4,44,1 3,44,1 1,44,1 4,44,1 3,44,1 1,44,1 4,44,1 3,44,1
4,52,1 3,52,1 1,52,1 1,52,1 1,52,1 1,52,1 1,52,1 1,52,1 1,52,1
0,0,0 0,0,0 0,0,0 0,0,0 0,0,0 0,0,0 0,0,0 0,0,0 0,0,0
0,0,0 0,0,0 0,0,0 0,0,0 0,0,0 0,0,0 0,0,0 0,0,0 0,0,0
0,0,0 0,0,0 0,0,0 0,0,0 0,0,0 0,0,0 0,0,0 0,0,0 0,0,0