MODE 0
BALL 50
STARS 0/0/1890 35
ADDLINE 0,0,0 0,0,0 5,44,1 1,1,1 1,1,1 1,1,1 4,44,1 0,0,0 0,0,0
ADDLINE 0,0,0 5,47,1 6,47,1 1,1,1 12,0,2 1,1,1 6,47,1 4,47,1 0,0,0
ADDLINE 0,0,0 1,35,1 1,35,1 1,1,1 1,1,1 1,1,1 1,35,1 1,35,1 0,0,0
0,0,0 2,1,1 0,0,0 0,0,0 12,0,2 0,0,0 0,0,0 3,1,1 0,0,0
0,0,0 1,1,1 2,1,1 0,0,0 0,0,0 0,0,0 3,1,1 1,1,1 0,0,0
12,0,2 1,64,1 1,64,1 1,64,1 1,30,1 1,64,1 1,64,1 1,64,1 12,0,2
0,0,0 1,64,1 6,64,1 1,64,1 1,30,1 1,64,1 6,64,1 1,64,1 0,0,0
0,0,0 1,63,1 1,1,1 1,63,1 1,30,1 1,63,1 1,1,1 1,63,1 0,0,0
0,0,0 0,0,0 0,0,0 12,0,2 0,0,0 12,0,2 0,0,0 0,0,0 0,0,0
0,0,0 5,54,1 1,54,1 1,54,1 1,54,1 1,54,1 1,54,1 4,54,1 0,0,0
0,0,0 0,0,0 0,0,0 0,0,0 0,0,0 0,0,0 0,0,0 0,0,0 0,0,0
0,0,0 0,0,0 0,0,0 0,0,0 0,0,0 0,0,0 0,0,0 0,0,0 0,0,0