MODE 0
BALL 50
STARS 0/400/560
0,0,0 1,80,1 1,80,1 1,80,1 1,80,1 1,80,1 1,80,1 1,80,1 0,0,0
0,0,0 1,60,1 0,0,0 0,0,0 0,0,0 0,0,0 0,0,0 1,80,1 12,0,2
12,0,2 1,60,1 0,0,0 1,40,1 1,40,1 1,40,1 0,0,0 1,80,1 0,0,0
0,0,0 1,60,1 0,0,0 0,0,0 0,0,0 1,40,1 0,0,0 1,80,1 12,0,2
12,0,2 1,60,1 1,40,1 1,40,1 1,40,1 1,40,1 0,0,0 1,80,1 0,0,0
0,0,0 0,0,0 0,0,0 0,0,0 0,0,0 0,0,0 0,0,0 1,80,1 12,0,2
1,40,1 1,40,1 1,40,1 1,40,1 1,40,1 1,40,1 1,40,1 4,40,1 0,0,0
0,0,0 0,0,0 0,0,0 0,0,0 0,0,0 0,0,0 0,0,0 0,0,0 0,0,0
0,0,0 0,0,0 0,0,0 0,0,0 0,0,0 0,0,0 0,0,0 0,0,0 0,0,0