MODE 0
BALL 50
STARS 0/0/1295 35
ADDLINE 0,0,0 1,46,1 12,0,2 1,46,1 0,0,0 1,46,1 12,0,2 1,46,1 0,0,0
ADDLINE 0,0,0 1,48,1 9,0,2 1,48,1 9,0,2 1,48,1 9,0,2 1,48,1 0,0,0
ADDLINE 0,0,0 1,34,1 0,0,0 1,34,1 0,0,0 1,34,1 0,0,0 1,34,1 0,0,0
0,0,0 1,88,1 0,0,0 1,88,1 12,0,2 1,88,1 0,0,0 1,88,1 0,0,0
12,0,2 1,88,1 0,0,0 1,88,1 0,0,0 1,88,1 0,0,0 1,88,1 12,0,2
0,0,0 1,87,1 9,0,2 1,87,1 9,0,2 1,87,1 9,0,2 1,87,1 0,0,0
12,0,2 1,86,1 0,0,0 1,86,1 0,0,0 1,86,1 0,0,0 1,86,1 12,0,2
0,0,0 1,84,1 0,0,0 0,0,0 0,0,0 0,0,0 0,0,0 1,84,1 0,0,0
0,0,0 1,62,1 1,62,1 1,62,1 1,62,1 1,62,1 1,62,1 1,62,1 0,0,0
0,0,0 0,0,0 0,0,0 0,0,0 0,0,0 0,0,0 0,0,0 0,0,0 0,0,0
0,0,0 0,0,0 0,0,0 0,0,0 0,0,0 0,0,0 0,0,0 0,0,0 0,0,0
0,0,0 0,0,0 0,0,0 0,0,0 0,0,0 0,0,0 0,0,0 0,0,0 0,0,0