MODE 0
BALL 50
STARS 0/0/2065 35
ADDLINE 1,46,1 0,0,0 0,0,0 1,46,1 0,0,0 1,46,1 12,0,2 0,0,0 1,46,1
ADDLINE 1,48,1 1,48,1 12,0,2 1,48,1 6,48,1 1,48,1 0,0,0 1,48,1 1,48,1
ADDLINE 1,39,1 1,39,1 0,0,0 1,39,1 8,0,2 1,39,1 0,0,0 1,48,1 1,39,1
1,58,1 1,58,1 1,58,1 1,58,1 1,58,1 1,58,1 1,58,1 1,58,1 1,58,1
1,58,1 6,58,1 1,58,1 1,58,1 6,58,1 1,58,1 1,58,1 6,58,1 1,58,1
1,52,1 1,52,1 1,52,1 1,52,1 1,52,1 1,52,1 1,52,1 1,52,1 1,52,1
0,0,0 12,0,2 0,0,0 12,0,2 7,0,2 12,0,2 0,0,0 12,0,2 0,0,0
0,0,0 1,62,1 1,62,1 1,62,1 1,62,1 1,62,1 1,62,1 1,62,1 0,0,0
0,0,0 0,0,0 0,0,0 9,0,2 0,0,0 9,0,2 0,0,0 0,0,0 0,0,0
0,0,0 5,62,1 1,62,1 1,62,1 1,62,1 1,62,1 1,62,1 4,62,1 0,0,0
0,0,0 0,0,0 0,0,0 0,0,0 0,0,0 0,0,0 0,0,0 0,0,0 0,0,0
0,0,0 0,0,0 0,0,0 0,0,0 0,0,0 0,0,0 0,0,0 0,0,0 0,0,0