MODE 0
BALL 50
STARS 0/0/2310 35
ADDLINE 1,46,1 1,46,1 1,46,1 2,46,1 11,0,2 3,46,1 1,46,1 1,46,1 1,46,1
ADDLINE 1,44,1 1,44,1 2,44,1 5,44,1 0,0,0 4,44,1 3,44,1 1,44,1 1,44,1
ADDLINE 0,0,0 0,0,0 5,37,1 1,37,1 12,0,2 1,37,1 4,37,1 0,0,0 0,0,0
7,0,2 1,50,1 2,50,1 5,50,1 12,0,2 4,50,1 3,50,1 1,50,1 7,0,2
2,54,1 5,54,1 1,54,1 2,54,1 0,0,0 3,54,1 1,54,1 4,54,1 3,54,1
1,61,1 2,61,1 5,61,1 1,61,1 11,0,2 1,61,1 4,61,1 3,61,1 1,61,1
5,62,1 1,62,1 2,62,1 5,62,1 0,0,0 4,62,1 3,62,1 1,62,1 4,62,1
2,64,1 5,64,1 1,64,1 2,64,1 12,0,2 3,64,1 1,64,1 4,64,1 3,64,1
12,0,2 0,0,0 0,0,0 0,0,0 0,0,0 0,0,0 0,0,0 0,0,0 12,0,2
1,102,1 1,102,1 1,102,1 1,102,1 11,0,2 1,102,1 1,102,1 1,102,1 1,102,1
0,0,0 0,0,0 0,0,0 0,0,0 0,0,0 0,0,0 0,0,0 0,0,0 0,0,0
0,0,0 0,0,0 0,0,0 0,0,0 0,0,0 0,0,0 0,0,0 0,0,0 0,0,0