MODE 0
BALL 50
STARS 0/0/1470 35
ADDLINE 0,0,0 1,47,1 1,47,1 1,47,1 1,47,1 1,47,1 1,47,1 1,47,1 12,0,2
ADDLINE 0,0,0 1,50,1 0,0,0 1,50,1 1,50,1 1,50,1 12,0,2 0,0,0 0,0,0
ADDLINE 1,38,1 1,38,1 12,0,2 1,38,1 1,38,1 1,38,1 0,0,0 1,38,1 1,38,1
0,0,0 1,80,1 1,80,1 0,0,0 12,0,2 0,0,0 20,40,1 1,80,1 0,0,0
0,0,0 1,80,1 20,40,1 0,0,0 0,0,0 0,0,0 1,80,1 1,80,1 0,0,0
0,0,0 1,88,1 1,88,1 0,0,0 12,0,2 0,0,0 20,44,1 1,88,1 0,0,0
0,0,0 1,88,1 20,44,1 0,0,0 0,0,0 0,0,0 1,88,1 1,88,1 0,0,0
0,0,0 1,96,1 1,96,1 0,0,0 12,0,2 0,0,0 20,48,1 1,96,1 0,0,0
0,0,0 1,96,1 20,48,1 0,0,0 0,0,0 0,0,0 1,96,1 1,96,1 0,0,0
0,0,0 0,0,0 0,0,0 0,0,0 0,0,0 0,0,0 0,0,0 0,0,0 0,0,0
0,0,0 0,0,0 0,0,0 0,0,0 0,0,0 0,0,0 0,0,0 0,0,0 0,0,0
0,0,0 0,0,0 0,0,0 0,0,0 0,0,0 0,0,0 0,0,0 0,0,0 0,0,0