MODE 0
BALL 50
STARS 0/0/2030 35
ADDLINE 4,44,1 3,44,1 1,44,1 1,44,1 1,44,1 1,44,1 1,44,1 1,44,1 12,0,2
ADDLINE 1,50,1 0,0,0 12,0,2 0,0,0 0,0,0 1,50,1 1,50,1 1,50,1 1,50,1
ADDLINE 1,39,1 0,0,0 0,0,0 12,0,2 1,39,1 1,39,1 1,39,1 1,39,1 1,39,1
4,45,1 0,0,0 12,0,2 0,0,0 12,0,2 0,0,0 12,0,2 0,0,0 5,45,1
0,0,0 3,85,1 1,85,1 1,85,1 1,5,1 1,85,1 1,85,1 2,85,1 12,0,2
0,0,0 1,5,1 20,47,1 1,5,1 1,5,1 1,5,1 20,47,1 1,5,1 12,0,2
0,0,0 1,86,1 1,86,1 1,86,1 1,5,1 1,86,1 1,86,1 1,86,1 0,0,0
2,45,1 5,45,1 1,45,1 1,85,1 20,45,1 1,85,1 1,45,1 4,45,1 3,45,1
1,44,1 2,44,1 5,44,1 1,84,1 1,84,1 1,84,1 4,45,1 3,44,1 1,44,1
0,0,0 0,0,0 0,0,0 0,0,0 0,0,0 0,0,0 0,0,0 0,0,0 0,0,0
0,0,0 0,0,0 0,0,0 0,0,0 0,0,0 0,0,0 0,0,0 0,0,0 0,0,0
0,0,0 0,0,0 0,0,0 0,0,0 0,0,0 0,0,0 0,0,0 0,0,0 0,0,0