MODE 0
BALL 50
STARS 0/0/1505 35
ADDLINE 5,49,1 1,49,1 0,0,0 1,49,1 12,0,2 0,0,0 20,49,1 0,0,0 1,49,1
ADDLINE 0,0,0 0,0,0 0,0,0 1,50,1 1,50,1 1,50,1 1,50,1 1,50,1 12,0,2
ADDLINE 0,0,0 1,39,1 1,39,1 0,0,0 0,0,0 0,0,0 1,39,1 12,0,2 1,39,1
0,0,0 0,0,0 2,10,1 0,0,0 0,0,0 0,0,0 3,10,1 0,0,0 0,0,0
0,0,0 3,96,1 20,48,1 1,96,1 12,0,2 1,96,1 20,48,1 2,96,1 0,0,0
12,0,2 1,84,1 1,84,1 5,84,1 1,42,1 4,84,1 1,84,1 1,84,1 0,0,0
0,0,0 0,0,0 5,46,1 1,46,1 12,0,2 1,46,1 4,46,1 12,0,2 0,0,0
0,0,0 0,0,0 0,0,0 5,43,1 2,43,1 4,43,1 0,0,0 12,0,2 0,0,0
2,52,1 0,0,0 2,52,1 3,52,1 0,0,0 2,52,1 3,52,1 2,52,1 3,52,1
0,0,0 0,0,0 0,0,0 0,0,0 0,0,0 0,0,0 0,0,0 0,0,0 0,0,0
0,0,0 0,0,0 0,0,0 0,0,0 0,0,0 0,0,0 0,0,0 0,0,0 0,0,0
0,0,0 0,0,0 0,0,0 0,0,0 0,0,0 0,0,0 0,0,0 0,0,0 0,0,0