MODE 0
BALL 50
STARS 0/0/1540 35
ADDLINE 1,49,1 12,0,2 1,49,1 0,0,0 5,49,1 0,0,0 1,49,1 0,0,0 1,49,1
ADDLINE 1,50,1 12,0,2 0,0,0 0,0,0 1,50,1 1,50,1 4,50,1 20,50,1 1,50,1
ADDLINE 2,40,1 1,40,1 1,40,1 0,0,0 5,40,1 12,0,2 1,40,1 0,0,0 1,40,1
0,0,0 0,0,0 0,0,0 12,0,2 1,10,1 12,0,2 0,0,0 0,0,0 0,0,0
0,0,0 1,45,1 12,0,2 1,90,1 20,45,1 1,90,1 12,0,2 1,45,1 0,0,0
0,0,0 1,47,1 0,0,0 12,0,2 1,94,1 12,0,2 0,0,0 1,47,1 0,0,0
0,0,0 1,46,1 0,0,0 3,92,1 20,46,1 2,92,1 0,0,0 1,46,1 0,0,0
0,0,0 4,45,1 12,0,2 1,90,1 1,90,1 1,90,1 12,0,2 5,45,1 0,0,0
0,0,0 1,42,1 1,42,1 1,42,1 1,42,1 1,42,1 1,42,1 1,42,1 0,0,0
0,0,0 0,0,0 0,0,0 0,0,0 0,0,0 0,0,0 0,0,0 0,0,0 0,0,0
0,0,0 0,0,0 0,0,0 0,0,0 0,0,0 0,0,0 0,0,0 0,0,0 0,0,0
0,0,0 0,0,0 0,0,0 0,0,0 0,0,0 0,0,0 0,0,0 0,0,0 0,0,0