MODE 0
BALL 50
STARS 0/0/1400 35
ADDLINE 1,49,1 1,49,1 0,0,0 1,49,1 0,0,0 12,0,2 0,0,0 1,49,1 0,0,0
ADDLINE 0,0,0 1,50,1 0,0,0 1,50,1 1,50,1 5,50,1 1,50,1 4,50,1 12,0,2
ADDLINE 0,0,0 1,40,1 1,40,1 1,40,1 12,0,2 1,40,1 0,0,0 3,40,1 0,0,0
0,0,0 0,0,0 3,96,1 1,96,1 1,48,1 1,96,1 2,96,1 0,0,0 0,0,0
0,0,0 12,0,2 20,48,1 12,0,2 1,2,1 12,0,2 20,48,1 12,0,2 0,0,0
5,2,1 4,88,1 1,88,1 1,2,1 1,2,1 1,2,1 1,88,1 5,88,1 4,2,1
0,0,0 0,0,0 0,0,0 5,46,1 12,0,2 4,46,1 0,0,0 0,0,0 0,0,0
0,0,0 0,0,0 0,0,0 0,0,0 0,0,0 0,0,0 0,0,0 0,0,0 0,0,0
0,0,0 0,0,0 4,62,1 1,62,1 1,62,1 1,62,1 5,62,1 0,0,0 0,0,0
0,0,0 0,0,0 0,0,0 0,0,0 0,0,0 0,0,0 0,0,0 0,0,0 0,0,0
0,0,0 0,0,0 0,0,0 0,0,0 0,0,0 0,0,0 0,0,0 0,0,0 0,0,0
0,0,0 0,0,0 0,0,0 0,0,0 0,0,0 0,0,0 0,0,0 0,0,0 0,0,0