MODE 0
BALL 50
STARS 0/0/1750 35
ADDLINE 1,49,1 12,0,2 1,49,1 0,0,0 0,0,0 1,49,1 1,49,1 0,0,0 1,49,1
ADDLINE 1,45,1 12,0,2 1,45,1 1,45,1 2,45,1 1,45,1 1,45,1 20,45,1 5,45,1
ADDLINE 3,40,1 0,0,0 0,0,0 12,0,2 0,0,0 1,40,1 1,40,1 1,40,1 1,40,1
0,0,0 0,0,0 0,0,0 0,0,0 0,0,0 0,0,0 0,0,0 0,0,0 0,0,0
20,48,1 1,96,1 1,96,1 20,48,1 1,96,1 1,96,1 20,48,1 1,96,1 12,0,2
1,96,1 1,96,1 1,96,1 1,96,1 1,96,1 1,96,1 1,96,1 1,96,1 0,0,0
12,0,2 0,0,0 12,0,2 0,0,0 12,0,2 0,0,0 12,0,2 0,0,0 12,0,2
0,0,0 1,92,1 20,46,1 1,92,1 1,92,1 20,46,1 1,92,1 1,92,1 20,46,1
0,0,0 1,90,1 1,90,1 1,90,1 1,90,1 1,90,1 1,90,1 1,90,1 1,90,1
0,0,0 0,0,0 0,0,0 0,0,0 0,0,0 0,0,0 0,0,0 0,0,0 0,0,0
0,0,0 0,0,0 0,0,0 0,0,0 0,0,0 0,0,0 0,0,0 0,0,0 0,0,0
0,0,0 0,0,0 0,0,0 0,0,0 0,0,0 0,0,0 0,0,0 0,0,0 0,0,0