MODE 0
BALL 50
STARS 0/200/300
0,0,0 3,40,1 1,40,1 2,40,1 12,0,2 3,40,1 1,40,1 2,40,1 0,0,0
0,0,0 1,40,1 1,1,1 1,1,1 1,1,1 1,1,1 1,1,1 1,40,1 0,0,0
0,0,0 1,40,1 1,1,1 1,1,1 1,1,1 1,1,1 1,1,1 1,40,1 0,0,0
0,0,0 5,40,1 1,1,1 1,1,1 1,1,1 1,1,1 1,1,1 4,40,1 0,0,0
0,0,0 0,0,0 5,40,1 1,1,1 1,1,1 1,1,1 4,40,1 0,0,0 0,0,0
0,0,0 0,0,0 0,0,0 5,40,1 1,40,1 4,40,1 0,0,0 0,0,0 0,0,0
0,0,0 0,0,0 0,0,0 0,0,0 0,0,0 0,0,0 0,0,0 0,0,0 0,0,0
0,0,0 0,0,0 0,0,0 0,0,0 0,0,0 0,0,0 0,0,0 0,0,0 0,0,0
0,0,0 0,0,0 0,0,0 0,0,0 0,0,0 0,0,0 0,0,0 0,0,0 0,0,0