MODE 0
BALL 50
STARS 0/0/2170 35
ADDLINE 1,50,1 1,50,1 1,50,1 1,50,1 12,0,2 1,50,1 8,0,2 1,50,1 1,50,1
ADDLINE 0,0,0 1,54,1 12,0,2 1,54,1 0,0,0 1,54,1 1,54,1 1,54,1 1,54,1
ADDLINE 1,61,1 0,0,0 12,0,2 1,61,1 0,0,0 1,61,1 0,0,0 1,61,1 0,0,0
ADDLINE 0,0,0 1,59,1 1,59,1 1,59,1 1,59,1 1,59,1 12,0,2 1,59,1 1,59,1
ADDLINE 0,0,0 1,63,1 0,0,0 10,0,2 0,0,0 12,0,2 0,0,0 1,63,1 0,0,0
ADDLINE 8,0,2 1,44,1 12,0,2 1,44,1 1,44,1 1,44,1 1,44,1 1,44,1 0,0,0
0,0,0 0,0,0 0,0,0 0,0,0 1,52,1 0,0,0 0,0,0 0,0,0 12,0,2
0,0,0 0,0,0 1,101,1 0,0,0 1,51,1 6,51,1 1,51,1 1,51,1 12,0,2
1,100,1 20,50,1 4,100,1 0,0,0 0,0,0 12,0,2 1,50,1 4,50,1 0,0,0
1,98,1 1,98,1 0,0,0 1,49,1 0,0,0 1,49,1 1,49,1 12,0,2 3,49,1
0,0,0 0,0,0 0,0,0 12,0,2 6,48,1 1,48,1 1,48,1 0,0,0 1,48,1
1,45,1 1,45,1 1,45,1 1,45,1 1,45,1 1,45,1 4,45,1 12,0,2 1,45,1
0,0,0 0,0,0 0,0,0 0,0,0 0,0,0 0,0,0 0,0,0 0,0,0 0,0,0
0,0,0 0,0,0 0,0,0 0,0,0 0,0,0 0,0,0 0,0,0 0,0,0 0,0,0
0,0,0 0,0,0 0,0,0 0,0,0 0,0,0 0,0,0 0,0,0 0,0,0 0,0,0