MODE 0
BALL 50
STARS 0/0/2170 35
ADDLINE 1,53,1 0,0,0 0,0,0 1,53,1 12,0,2 1,53,1 0,0,0 1,53,1 0,0,0
ADDLINE 1,51,1 1,51,1 12,0,2 1,51,1 1,51,1 1,51,1 0,0,0 1,51,1 1,51,1
ADDLINE 0,0,0 1,61,1 12,0,2 1,61,1 0,0,0 1,61,1 1,61,1 0,0,0 0,0,0
ADDLINE 0,0,0 1,62,1 1,62,1 1,62,1 12,0,2 1,62,1 1,62,1 1,62,1 0,0,0
ADDLINE 0,0,0 0,0,0 0,0,0 1,63,1 1,63,1 1,63,1 12,0,2 0,0,0 0,0,0
ADDLINE 1,42,1 1,42,1 12,0,2 1,42,1 1,42,1 1,42,1 0,0,0 1,42,1 1,42,1
1,104,1 1,104,1 0,0,0 0,0,0 12,0,2 0,0,0 0,0,0 1,52,1 1,52,1
1,92,1 20,46,1 12,0,2 1,46,1 1,46,1 1,46,1 1,46,1 1,46,1 1,46,1
1,100,1 0,0,0 12,0,2 0,0,0 0,0,0 0,0,0 0,0,0 0,0,0 6,50,1
1,47,1 12,0,2 1,47,1 1,47,1 1,47,1 1,47,1 1,47,1 12,0,2 1,47,1
1,48,1 0,0,0 1,48,1 0,0,0 0,0,0 0,0,0 0,0,0 12,0,2 1,48,1
0,0,0 0,0,0 1,63,1 1,63,1 1,63,1 1,63,1 1,63,1 1,63,1 1,63,1
0,0,0 0,0,0 0,0,0 0,0,0 0,0,0 0,0,0 0,0,0 0,0,0 0,0,0
0,0,0 0,0,0 0,0,0 0,0,0 0,0,0 0,0,0 0,0,0 0,0,0 0,0,0
0,0,0 0,0,0 0,0,0 0,0,0 0,0,0 0,0,0 0,0,0 0,0,0 0,0,0