MODE 0
BALL 50
STARS 0/0/2135 35
ADDLINE 1,53,1 12,0,2 12,0,2 1,53,1 1,53,1 1,53,1 0,0,0 0,0,0 1,53,1
ADDLINE 1,54,1 0,0,0 1,54,1 1,54,1 1,54,1 12,0,2 0,0,0 1,54,1 1,54,1
ADDLINE 0,0,0 0,0,0 1,61,1 0,0,0 12,0,2 0,0,0 1,61,1 1,61,1 20,61,1
ADDLINE 0,0,0 1,59,1 1,59,1 1,59,1 1,59,1 1,59,1 1,59,1 12,0,2 1,59,1
ADDLINE 0,0,0 1,63,1 1,63,1 1,63,1 1,63,1 1,63,1 1,63,1 0,0,0 12,0,2
ADDLINE 0,0,0 12,0,2 0,0,0 0,0,0 1,44,1 1,44,1 1,44,1 0,0,0 0,0,0
1,48,1 4,48,1 0,0,0 0,0,0 1,48,1 0,0,0 0,0,0 5,48,1 1,48,1
4,49,1 0,0,0 12,0,2 1,49,1 6,49,1 1,49,1 12,0,2 0,0,0 5,49,1
0,0,0 0,0,0 0,0,0 1,100,1 1,50,1 1,100,1 0,0,0 0,0,0 12,0,2
11,0,2 1,98,1 20,48,1 1,98,1 1,49,1 1,98,1 20,48,1 1,98,1 12,0,2
1,53,1 1,106,1 1,106,1 1,160,1 1,53,1 1,106,1 1,106,1 1,106,1 0,0,0
0,0,0 0,0,0 12,0,2 0,0,0 0,0,0 0,0,0 12,0,2 0,0,0 0,0,0
0,0,0 0,0,0 0,0,0 0,0,0 0,0,0 0,0,0 0,0,0 0,0,0 0,0,0
0,0,0 0,0,0 0,0,0 0,0,0 0,0,0 0,0,0 0,0,0 0,0,0 0,0,0
0,0,0 0,0,0 0,0,0 0,0,0 0,0,0 0,0,0 0,0,0 0,0,0 0,0,0