MODE 0
BALL 50
STARS 0/0/2450 35
ADDLINE 1,50,1 3,50,1 1,50,1 1,50,1 12,0,2 5,50,1 1,50,1 1,50,1 0,0,0
ADDLINE 4,54,1 1,54,1 1,54,1 0,0,0 0,0,0 12,0,2 0,0,0 0,0,0 0,0,0
ADDLINE 1,61,1 1,61,1 12,0,2 0,0,0 1,61,1 0,0,0 5,61,1 1,61,1 0,0,0
ADDLINE 1,62,1 1,62,1 0,0,0 12,0,2 1,62,1 1,62,1 0,0,0 3,62,1 1,62,1
ADDLINE 5,59,1 4,59,1 1,59,1 20,59,1 1,59,1 12,0,2 1,59,1 0,0,0 1,59,1
ADDLINE 1,44,1 0,0,0 1,44,1 1,44,1 1,44,1 1,44,1 0,0,0 12,0,2 1,44,1
0,0,0 1,72,1 1,72,1 1,72,1 1,72,1 1,72,1 1,72,1 0,0,0 0,0,0
1,79,1 4,79,1 0,0,0 0,0,0 12,0,2 5,79,1 1,79,1 1,79,1 0,0,0
1,80,1 12,0,2 3,160,1 1,160,1 2,160,1 12,0,2 5,80,1 1,80,1 0,0,0
1,79,1 0,0,0 1,158,1 20,79,1 1,158,1 2,79,1 12,0,2 0,0,0 8,0,2
1,68,1 2,68,1 5,136,1 1,136,1 1,136,1 1,68,1 2,68,1 12,0,2 0,0,0
0,0,0 1,65,1 12,0,2 5,65,1 1,65,1 1,65,1 1,65,1 1,65,1 1,65,1
0,0,0 0,0,0 0,0,0 0,0,0 0,0,0 0,0,0 0,0,0 0,0,0 0,0,0
0,0,0 0,0,0 0,0,0 0,0,0 0,0,0 0,0,0 0,0,0 0,0,0 0,0,0
0,0,0 0,0,0 0,0,0 0,0,0 0,0,0 0,0,0 0,0,0 0,0,0 0,0,0