MODE 0
BALL 50
STARS 0/0/2415 35
ADDLINE 0,0,0 1,47,1 1,47,1 1,47,1 1,47,1 1,47,1 1,47,1 0,0,0 0,0,0
ADDLINE 1,47,1 1,2,1 1,2,1 1,2,1 1,2,1 1,2,1 1,2,1 1,2,1 0,0,0
ADDLINE 1,47,1 1,2,1 1,47,1 1,47,1 1,47,1 1,47,1 1,47,1 1,47,1 1,47,1
ADDLINE 1,52,1 1,2,1 1,2,1 1,2,1 1,2,1 1,2,1 1,2,1 1,2,1 1,52,1
ADDLINE 0,0,0 1,49,1 1,49,1 1,49,1 1,49,1 1,49,1 1,49,1 1,49,1 0,0,0
ADDLINE 0,0,0 1,34,1 1,34,1 1,34,1 1,34,1 1,34,1 1,34,1 1,34,1 0,0,0
0,0,0 0,0,0 0,0,0 1,60,1 0,0,0 1,60,1 0,0,0 0,0,0 0,0,0
1,62,1 1,62,1 1,62,1 1,62,1 0,0,0 1,62,1 1,62,1 1,62,1 1,62,1
1,60,1 0,0,0 0,0,0 0,0,0 0,0,0 0,0,0 0,0,0 0,0,0 1,60,1
1,58,1 0,0,0 1,116,1 20,58,1 1,116,1 20,58,1 1,116,1 0,0,0 1,58,1
1,56,1 0,0,0 1,112,1 0,0,0 0,0,0 0,0,0 1,112,1 0,0,0 1,56,1
1,54,1 0,0,0 1,54,1 0,0,0 0,0,0 0,0,0 1,54,1 0,0,0 1,54,1
0,0,0 0,0,0 0,0,0 0,0,0 0,0,0 0,0,0 0,0,0 0,0,0 0,0,0
0,0,0 0,0,0 0,0,0 0,0,0 0,0,0 0,0,0 0,0,0 0,0,0 0,0,0
0,0,0 0,0,0 0,0,0 0,0,0 0,0,0 0,0,0 0,0,0 0,0,0 0,0,0