MODE 0
BALL 50
STARS 0/0/2205 35
ADDLINE 0,0,0 1,50,1 1,50,1 1,50,1 1,50,1 1,50,1 12,0,2 5,50,1 1,50,1
ADDLINE 0,0,0 0,0,0 1,54,1 20,54,1 0,0,0 1,54,1 12,0,2 0,0,0 0,0,0
ADDLINE 1,61,1 1,61,1 10,0,2 1,61,1 12,0,2 1,61,1 1,61,1 1,61,1 0,0,0
ADDLINE 0,0,0 1,62,1 1,62,1 16,62,1 1,62,1 12,0,2 1,62,1 1,62,1 1,62,1
ADDLINE 0,0,0 1,63,1 10,0,2 1,63,1 1,63,1 1,63,1 12,0,2 1,63,1 0,0,0
ADDLINE 0,0,0 1,44,1 0,0,0 20,44,1 12,0,2 0,0,0 0,0,0 1,44,1 0,0,0
20,52,1 1,104,1 12,0,2 1,52,1 1,52,1 1,52,1 12,0,2 1,104,1 20,52,1
1,102,1 1,102,1 0,0,0 5,51,1 12,0,2 4,51,1 0,0,0 1,102,1 1,102,1
0,0,0 1,50,1 2,50,1 0,0,0 1,50,1 0,0,0 3,50,1 1,50,1 0,0,0
1,49,1 0,0,0 0,0,0 12,0,2 0,0,0 12,0,2 0,0,0 0,0,0 1,49,1
1,46,1 1,46,1 1,46,1 12,0,2 0,0,0 12,0,2 1,46,1 1,46,1 1,46,1
0,0,0 1,52,1 1,52,1 2,52,1 11,0,2 3,52,1 1,52,1 1,52,1 0,0,0
0,0,0 0,0,0 0,0,0 0,0,0 0,0,0 0,0,0 0,0,0 0,0,0 0,0,0
0,0,0 0,0,0 0,0,0 0,0,0 0,0,0 0,0,0 0,0,0 0,0,0 0,0,0
0,0,0 0,0,0 0,0,0 0,0,0 0,0,0 0,0,0 0,0,0 0,0,0 0,0,0