MODE 0
BALL 50
STARS 0/0/2100 35
ADDLINE 1,53,1 1,53,1 0,0,0 0,0,0 12,0,2 1,53,1 0,0,0 5,53,1 0,0,0
ADDLINE 0,0,0 1,54,1 1,54,1 1,54,1 12,0,2 1,54,1 0,0,0 1,54,1 3,54,1
ADDLINE 1,61,1 1,61,1 0,0,0 1,61,1 0,0,0 2,61,1 0,0,0 1,61,1 12,0,2
ADDLINE 1,56,1 20,56,1 2,56,1 3,56,1 12,0,2 5,56,1 1,56,1 1,56,1 1,56,1
ADDLINE 1,63,1 1,63,1 0,0,0 4,63,1 0,0,0 4,63,1 12,0,2 1,63,1 0,0,0
ADDLINE 0,0,0 1,44,1 12,0,2 1,44,1 0,0,0 1,44,1 0,0,0 1,44,1 1,44,1
1,52,1 4,52,1 0,0,0 0,0,0 0,0,0 0,0,0 0,0,0 12,0,2 0,0,0
0,0,0 0,0,0 0,0,0 0,0,0 1,51,1 4,51,1 12,0,2 0,0,0 3,102,1
0,0,0 1,48,1 1,48,1 1,48,1 4,48,1 12,0,2 3,96,1 20,48,1 1,96,1
0,0,0 0,0,0 6,49,1 1,49,1 0,0,0 0,0,0 12,0,2 1,98,1 4,98,1
1,48,1 1,48,1 12,0,2 1,48,1 0,0,0 5,48,1 1,48,1 0,0,0 0,0,0
1,47,1 1,47,1 1,47,1 1,47,1 2,47,1 0,0,0 12,0,2 3,47,1 1,47,1
0,0,0 0,0,0 0,0,0 0,0,0 0,0,0 0,0,0 0,0,0 0,0,0 0,0,0
0,0,0 0,0,0 0,0,0 0,0,0 0,0,0 0,0,0 0,0,0 0,0,0 0,0,0
0,0,0 0,0,0 0,0,0 0,0,0 0,0,0 0,0,0 0,0,0 0,0,0 0,0,0