MODE 0
BALL 50
STARS 0/400/800
0,0,0 0,0,0 0,0,0 0,0,0 0,0,0 5,30,1 2,30,1 0,0,0 0,0,0
0,0,0 2,30,1 0,0,0 2,30,1 12,0,2 2,30,1 5,30,1 2,70,1 12,0,2
2,30,1 5,30,1 2,30,1 5,30,1 2,30,1 5,30,1 0,0,0 1,70,1 0,0,0
5,30,1 2,30,1 5,30,1 2,30,1 5,30,1 2,30,1 0,0,0 1,70,1 0,0,0
0,0,0 0,0,0 0,0,0 0,0,0 12,0,2 0,0,0 0,0,0 1,70,1 12,0,2
1,50,1 1,50,1 1,50,1 1,50,1 1,50,1 1,50,1 1,50,1 1,70,1 0,0,0
0,0,0 0,0,0 0,0,0 0,0,0 0,0,0 0,0,0 0,0,0 0,0,0 0,0,0
0,0,0 0,0,0 0,0,0 0,0,0 0,0,0 0,0,0 0,0,0 0,0,0 0,0,0
0,0,0 0,0,0 0,0,0 0,0,0 0,0,0 0,0,0 0,0,0 0,0,0 0,0,0