MODE 0
BALL 50
STARS 0/0/2100 35
ADDLINE 1,53,1 1,53,1 0,0,0 1,53,1 12,0,2 1,53,1 0,0,0 1,53,1 0,0,0
ADDLINE 0,0,0 0,0,0 12,0,2 1,54,1 0,0,0 1,54,1 0,0,0 1,54,1 0,0,0
ADDLINE 0,0,0 1,58,1 1,58,1 1,58,1 12,0,2 1,58,1 1,58,1 20,58,1 1,58,1
ADDLINE 0,0,0 0,0,0 0,0,0 1,62,1 0,0,0 0,0,0 12,0,2 1,62,1 1,62,1
ADDLINE 1,59,1 1,59,1 12,0,2 1,59,1 1,59,1 1,59,1 0,0,0 1,59,1 1,59,1
ADDLINE 0,0,0 1,44,1 12,0,2 1,44,1 0,0,0 1,44,1 1,44,1 1,44,1 1,44,1
1,74,1 0,0,0 0,0,0 0,0,0 12,0,2 0,0,0 1,54,1 0,0,0 1,54,1
1,76,1 0,0,0 1,56,1 6,56,1 1,56,1 12,0,2 5,56,1 0,0,0 0,0,0
1,76,1 0,0,0 1,56,1 1,56,1 1,56,1 11,0,2 12,0,2 1,56,1 0,0,0
1,74,1 0,0,0 1,54,1 1,54,1 1,54,1 0,0,0 3,54,1 1,54,1 12,0,2
1,68,1 12,0,2 1,48,1 1,48,1 0,0,0 0,0,0 0,0,0 0,0,0 0,0,0
1,67,1 12,0,2 0,0,0 1,47,1 1,47,1 1,47,1 1,47,1 1,47,1 1,47,1
0,0,0 0,0,0 0,0,0 0,0,0 0,0,0 0,0,0 0,0,0 0,0,0 0,0,0
0,0,0 0,0,0 0,0,0 0,0,0 0,0,0 0,0,0 0,0,0 0,0,0 0,0,0
0,0,0 0,0,0 0,0,0 0,0,0 0,0,0 0,0,0 0,0,0 0,0,0 0,0,0