MODE 0
BALL 50
STARS 0/0/2240 35
ADDLINE 0,0,0 0,0,0 1,53,1 1,53,1 16,53,1 1,53,1 12,0,2 1,53,1 0,0,0
ADDLINE 1,51,1 1,51,1 1,51,1 1,51,1 1,51,1 12,0,2 0,0,0 1,51,1 1,51,1
ADDLINE 0,0,0 1,61,1 0,0,0 0,0,0 12,0,2 1,61,1 0,0,0 1,61,1 0,0,0
ADDLINE 1,62,1 1,62,1 0,0,0 1,62,1 1,62,1 1,62,1 0,0,0 1,62,1 12,0,2
ADDLINE 1,63,1 16,63,1 1,63,1 1,63,1 0,0,0 0,0,0 12,0,2 1,63,1 1,63,1
ADDLINE 1,44,1 1,44,1 0,0,0 1,44,1 12,0,2 1,44,1 1,44,1 16,44,1 1,44,1
1,138,1 1,138,1 1,138,1 1,138,1 1,138,1 1,138,1 1,138,1 16,69,1 1,138,1
0,0,0 12,0,2 0,0,0 0,0,0 0,0,0 12,0,2 0,0,0 0,0,0 1,70,1
0,0,0 1,70,1 1,70,1 1,70,1 12,0,2 0,0,0 0,0,0 0,0,0 1,70,1
12,0,2 1,138,1 0,0,0 1,138,1 1,138,1 1,138,1 16,69,1 12,0,2 1,138,1
0,0,0 1,96,1 0,0,0 0,0,0 0,0,0 12,0,2 0,0,0 0,0,0 1,48,1
0,0,0 1,67,1 1,67,1 1,67,1 1,67,1 1,67,1 1,67,1 1,67,1 1,67,1
0,0,0 0,0,0 0,0,0 0,0,0 0,0,0 0,0,0 0,0,0 0,0,0 0,0,0
0,0,0 0,0,0 0,0,0 0,0,0 0,0,0 0,0,0 0,0,0 0,0,0 0,0,0
0,0,0 0,0,0 0,0,0 0,0,0 0,0,0 0,0,0 0,0,0 0,0,0 0,0,0