MODE 0
BALL 50
STARS 0/0/2205 35
ADDLINE 1,53,1 0,0,0 0,0,0 12,0,2 1,53,1 0,0,0 1,53,1 1,53,1 0,0,0
ADDLINE 1,54,1 1,54,1 1,54,1 1,54,1 12,0,2 0,0,0 1,54,1 0,0,0 0,0,0
ADDLINE 1,58,1 1,58,1 1,58,1 0,0,0 12,0,2 1,58,1 1,58,1 1,58,1 1,58,1
ADDLINE 1,62,1 0,0,0 1,62,1 0,0,0 12,0,2 0,0,0 0,0,0 1,62,1 1,62,1
ADDLINE 0,0,0 12,0,2 1,63,1 1,63,1 1,63,1 1,63,1 1,63,1 0,0,0 0,0,0
ADDLINE 1,42,1 12,0,2 1,42,1 1,42,1 16,42,1 1,42,1 1,42,1 1,42,1 0,0,0
3,98,1 12,0,2 3,98,1 1,98,1 16,49,1 1,98,1 2,98,1 12,0,2 2,98,1
1,61,1 12,0,2 1,61,1 0,0,0 1,61,1 0,0,0 1,61,1 12,0,2 1,61,1
1,58,1 12,0,2 5,58,1 1,58,1 1,58,1 1,58,1 4,58,1 12,0,2 1,58,1
1,59,1 0,0,0 0,0,0 0,0,0 1,59,1 1,59,1 0,0,0 0,0,0 1,59,1
5,96,1 2,96,1 0,0,0 1,96,1 1,96,1 1,96,1 16,48,1 1,96,1 4,96,1
0,0,0 0,0,0 0,0,0 0,0,0 0,0,0 0,0,0 0,0,0 0,0,0 0,0,0
0,0,0 0,0,0 0,0,0 0,0,0 0,0,0 0,0,0 0,0,0 0,0,0 0,0,0
0,0,0 0,0,0 0,0,0 0,0,0 0,0,0 0,0,0 0,0,0 0,0,0 0,0,0
0,0,0 0,0,0 0,0,0 0,0,0 0,0,0 0,0,0 0,0,0 0,0,0 0,0,0