MODE 0
BALL 50
STARS 0/0/2310 35
ADDLINE 1,53,1 4,53,1 1,53,1 0,0,0 0,0,0 12,0,2 0,0,0 0,0,0 1,53,1
ADDLINE 1,51,1 1,51,1 1,51,1 12,0,2 4,51,1 1,51,1 0,0,0 1,51,1 1,51,1
ADDLINE 1,58,1 2,58,1 16,58,1 0,0,0 1,58,1 1,58,1 12,0,2 5,58,1 1,58,1
ADDLINE 1,62,1 1,62,1 12,0,2 0,0,0 1,62,1 1,62,1 0,0,0 0,0,0 0,0,0
ADDLINE 0,0,0 12,0,2 5,59,1 1,59,1 1,59,1 1,59,1 1,59,1 4,59,1 1,59,1
ADDLINE 1,44,1 12,0,2 0,0,0 1,44,1 0,0,0 0,0,0 1,44,1 1,44,1 2,44,1
0,0,0 1,62,1 4,62,1 0,0,0 12,0,2 0,0,0 12,0,2 1,62,1 0,0,0
1,138,1 4,138,1 3,138,1 1,138,1 1,138,1 16,69,1 2,139,1 1,139,1 12,0,2
1,80,1 0,0,0 1,80,1 4,80,1 0,0,0 5,80,1 1,80,1 1,80,1 0,0,0
1,79,1 2,79,1 5,79,1 3,79,1 12,0,2 2,79,1 0,0,0 0,0,0 0,0,0
0,0,0 1,116,1 0,0,0 5,116,1 1,116,1 1,116,1 1,116,1 16,58,1 12,0,2
0,0,0 1,63,1 12,0,2 0,0,0 0,0,0 1,63,1 0,0,0 1,63,1 1,63,1
0,0,0 0,0,0 0,0,0 0,0,0 0,0,0 0,0,0 0,0,0 0,0,0 0,0,0
0,0,0 0,0,0 0,0,0 0,0,0 0,0,0 0,0,0 0,0,0 0,0,0 0,0,0
0,0,0 0,0,0 0,0,0 0,0,0 0,0,0 0,0,0 0,0,0 0,0,0 0,0,0