MODE 0
BALL 50
STARS 0/0/2170 35
ADDLINE 0,0,0 1,53,1 10,0,2 5,53,1 1,53,1 1,53,1 4,53,1 3,53,1 12,0,2
ADDLINE 1,54,1 1,54,1 0,0,0 0,0,0 0,0,0 1,54,1 0,0,0 12,0,2 1,54,1
ADDLINE 1,58,1 1,58,1 2,58,1 5,58,1 0,0,0 1,58,1 12,0,2 1,58,1 1,58,1
ADDLINE 0,0,0 1,62,1 0,0,0 1,62,1 1,62,1 1,62,1 0,0,0 0,0,0 12,0,2
ADDLINE 1,59,1 1,59,1 1,59,1 1,59,1 12,0,2 1,59,1 1,59,1 1,59,1 10,0,2
ADDLINE 0,0,0 12,0,2 0,0,0 1,44,1 0,0,0 0,0,0 0,0,0 1,44,1 0,0,0
1,72,1 1,72,1 0,0,0 0,0,0 12,0,2 0,0,0 0,0,0 0,0,0 1,72,1
1,121,1 1,121,1 0,0,0 12,0,2 16,61,1 1,121,1 0,0,0 0,0,0 1,121,1
1,78,1 1,78,1 12,0,2 0,0,0 1,78,1 1,78,1 1,78,1 0,0,0 1,78,1
1,69,1 3,69,1 12,0,2 0,0,0 12,0,2 1,69,1 0,0,0 0,0,0 1,69,1
5,112,1 1,112,1 16,56,1 1,112,1 12,0,2 1,112,1 0,0,0 5,112,1 1,112,1
0,0,0 0,0,0 1,50,1 1,50,1 2,50,1 2,50,1 2,50,1 0,0,0 5,50,1
0,0,0 0,0,0 0,0,0 0,0,0 0,0,0 0,0,0 0,0,0 0,0,0 0,0,0
0,0,0 0,0,0 0,0,0 0,0,0 0,0,0 0,0,0 0,0,0 0,0,0 0,0,0
0,0,0 0,0,0 0,0,0 0,0,0 0,0,0 0,0,0 0,0,0 0,0,0 0,0,0