MODE 0
BALL 50
STARS 0/0/2240 35
ADDLINE 1,50,1 1,50,1 3,50,1 4,50,1 12,0,2 3,50,1 1,50,1 1,50,1 0,0,0
ADDLINE 0,0,0 0,0,0 0,0,0 1,54,1 12,0,2 0,0,0 0,0,0 1,54,1 1,54,1
ADDLINE 0,0,0 1,61,1 1,61,1 1,61,1 2,61,1 5,61,1 0,0,0 2,61,1 12,0,2
ADDLINE 0,0,0 16,62,1 0,0,0 0,0,0 0,0,0 1,62,1 1,62,1 1,62,1 12,0,2
ADDLINE 1,59,1 2,59,1 1,59,1 4,59,1 0,0,0 1,59,1 12,0,2 1,59,1 1,59,1
ADDLINE 1,44,1 5,44,1 0,0,0 1,44,1 0,0,0 1,44,1 0,0,0 12,0,2 1,44,1
0,0,0 0,0,0 12,0,2 0,0,0 12,0,2 0,0,0 12,0,2 0,0,0 0,0,0
16,140,1 1,140,1 1,140,1 1,140,1 1,140,1 1,140,1 1,70,1 1,140,1 0,0,0
1,136,1 1,136,1 1,136,1 1,136,1 1,136,1 1,136,1 16,68,1 1,136,1 0,0,0
0,0,0 0,0,0 12,0,2 0,0,0 12,0,2 0,0,0 12,0,2 0,0,0 0,0,0
0,0,0 1,132,1 16,66,1 1,132,1 1,132,1 1,132,1 1,132,1 1,132,1 1,132,1
0,0,0 1,128,1 1,128,1 1,128,1 1,128,1 1,128,1 1,128,1 1,128,1 16,64,1
0,0,0 0,0,0 0,0,0 0,0,0 0,0,0 0,0,0 0,0,0 0,0,0 0,0,0
0,0,0 0,0,0 0,0,0 0,0,0 0,0,0 0,0,0 0,0,0 0,0,0 0,0,0
0,0,0 0,0,0 0,0,0 0,0,0 0,0,0 0,0,0 0,0,0 0,0,0 0,0,0