MODE 0
BALL 50
STARS 0/0/2450 35
ADDLINE 0,0,0 5,53,1 12,0,2 1,53,1 1,53,1 1,53,1 0,0,0 1,53,1 0,0,0
ADDLINE 0,0,0 1,54,1 12,0,2 4,54,1 0,0,0 1,54,1 1,54,1 1,54,1 0,0,0
ADDLINE 1,61,1 1,61,1 0,0,0 1,61,1 0,0,0 12,0,2 0,0,0 2,61,1 0,0,0
ADDLINE 1,59,1 5,59,1 0,0,0 3,59,1 16,59,1 1,59,1 12,0,2 1,59,1 1,59,1
ADDLINE 1,63,1 1,63,1 0,0,0 4,63,1 0,0,0 1,63,1 0,0,0 0,0,0 12,0,2
ADDLINE 1,42,1 2,42,1 3,42,1 1,42,1 0,0,0 1,42,1 1,42,1 3,42,1 12,0,2
0,0,0 0,0,0 0,0,0 1,170,1 1,170,1 1,170,1 1,170,1 1,170,1 16,85,1
16,80,1 12,0,2 0,0,0 1,160,1 1,160,1 1,160,1 1,160,1 1,160,1 1,160,1
0,0,0 0,0,0 0,0,0 1,150,1 1,150,1 16,75,1 1,150,1 1,150,1 1,150,1
0,0,0 0,0,0 12,0,2 16,70,1 1,140,1 1,140,1 1,140,1 1,140,1 1,140,1
0,0,0 0,0,0 0,0,0 1,130,1 1,130,1 1,130,1 1,130,1 16,65,1 1,130,1
16,60,1 12,0,2 0,0,0 1,120,1 1,120,1 1,120,1 1,120,1 1,120,1 1,120,1
0,0,0 0,0,0 0,0,0 0,0,0 0,0,0 0,0,0 0,0,0 0,0,0 0,0,0
0,0,0 0,0,0 0,0,0 0,0,0 0,0,0 0,0,0 0,0,0 0,0,0 0,0,0
0,0,0 0,0,0 0,0,0 0,0,0 0,0,0 0,0,0 0,0,0 0,0,0 0,0,0