MODE 0
BALL 50
STARS 0/0/2380 35
ADDLINE 0,0,0 0,0,0 1,53,1 0,0,0 12,0,2 0,0,0 5,53,1 1,53,1 1,53,1
ADDLINE 0,0,0 1,54,1 1,54,1 1,54,1 1,54,1 0,0,0 12,0,2 0,0,0 1,54,1
ADDLINE 0,0,0 0,0,0 0,0,0 1,61,1 12,0,2 1,61,1 1,61,1 0,0,0 1,61,1
ADDLINE 1,62,1 1,62,1 1,62,1 8,0,2 0,0,0 12,0,2 0,0,0 0,0,0 0,0,0
ADDLINE 1,56,1 1,56,1 1,56,1 1,56,1 1,56,1 1,56,1 1,56,1 1,56,1 12,0,2
ADDLINE 1,44,1 1,44,1 1,44,1 1,44,1 12,0,2 0,0,0 1,44,1 1,44,1 0,0,0
4,130,1 0,0,0 0,0,0 3,130,1 1,130,1 2,130,1 12,0,2 0,0,0 0,0,0
0,0,0 12,0,2 3,94,1 4,94,1 12,0,2 5,94,1 1,94,1 1,94,1 12,0,2
0,0,0 3,92,1 1,92,1 12,0,2 1,92,1 2,92,1 12,0,2 0,0,0 0,0,0
2,140,1 5,140,1 1,140,1 16,70,1 1,140,1 1,140,1 1,140,1 1,140,1 1,140,1
1,140,1 2,140,1 5,140,1 1,140,1 16,70,1 1,140,1 1,140,1 1,140,1 1,140,1
1,67,1 1,67,1 0,0,0 5,67,1 1,67,1 1,67,1 1,67,1 1,67,1 1,67,1
0,0,0 0,0,0 0,0,0 0,0,0 0,0,0 0,0,0 0,0,0 0,0,0 0,0,0
0,0,0 0,0,0 0,0,0 0,0,0 0,0,0 0,0,0 0,0,0 0,0,0 0,0,0
0,0,0 0,0,0 0,0,0 0,0,0 0,0,0 0,0,0 0,0,0 0,0,0 0,0,0