MODE 0
BALL 50
STARS 0/0/2310 35
ADDLINE 0,0,0 1,53,1 1,53,1 1,53,1 0,0,0 1,53,1 12,0,2 1,53,1 0,0,0
ADDLINE 0,0,0 1,54,1 0,0,0 12,0,2 0,0,0 1,54,1 0,0,0 1,54,1 1,54,1
ADDLINE 1,58,1 1,58,1 0,0,0 1,58,1 1,58,1 1,58,1 1,58,1 1,58,1 12,0,2
ADDLINE 1,62,1 1,62,1 12,0,2 1,62,1 0,0,0 0,0,0 0,0,0 1,62,1 1,62,1
ADDLINE 1,59,1 1,59,1 9,0,2 1,59,1 1,59,1 1,59,1 12,0,2 1,59,1 1,59,1
ADDLINE 1,44,1 1,44,1 0,0,0 12,0,2 1,44,1 1,44,1 1,44,1 1,44,1 0,0,0
0,0,0 1,74,1 1,74,1 4,74,1 12,0,2 0,0,0 0,0,0 11,0,2 1,74,1
4,68,1 12,0,2 0,0,0 3,68,1 1,68,1 1,68,1 2,68,1 0,0,0 1,68,1
2,65,1 12,0,2 12,0,2 5,65,1 1,65,1 1,65,1 1,65,1 0,0,0 1,65,1
1,60,1 1,60,1 2,60,1 0,0,0 0,0,0 5,60,1 1,60,1 0,0,0 1,60,1
1,128,1 1,128,1 1,128,1 1,128,1 0,0,0 12,0,2 1,128,1 16,64,1 1,128,1
0,0,0 0,0,0 1,57,1 0,0,0 12,0,2 0,0,0 0,0,0 1,57,1 1,57,1
0,0,0 0,0,0 0,0,0 0,0,0 0,0,0 0,0,0 0,0,0 0,0,0 0,0,0
0,0,0 0,0,0 0,0,0 0,0,0 0,0,0 0,0,0 0,0,0 0,0,0 0,0,0
0,0,0 0,0,0 0,0,0 0,0,0 0,0,0 0,0,0 0,0,0 0,0,0 0,0,0