MODE 0
BALL 50
STARS 0/0/2100 35
ADDLINE 0,0,0 1,53,1 0,0,0 0,0,0 0,0,0 1,53,1 10,0,2 1,53,1 12,0,2
ADDLINE 0,0,0 1,54,1 10,0,2 1,54,1 12,0,2 1,54,1 0,0,0 1,54,1 1,54,1
ADDLINE 0,0,0 1,61,1 12,0,2 1,61,1 0,0,0 0,0,0 0,0,0 1,61,1 1,61,1
ADDLINE 1,62,1 16,62,1 0,0,0 1,62,1 1,62,1 1,62,1 1,62,1 1,62,1 12,0,2
ADDLINE 1,63,1 1,63,1 11,0,2 1,63,1 0,0,0 12,0,2 0,0,0 0,0,0 0,0,0
ADDLINE 0,0,0 1,42,1 1,42,1 1,42,1 1,42,1 1,42,1 12,0,2 1,42,1 1,42,1
0,0,0 6,84,1 1,84,1 12,0,2 0,0,0 0,0,0 12,0,2 0,0,0 1,84,1
1,82,1 1,82,1 1,164,1 1,164,1 1,164,1 12,0,2 0,0,0 1,82,1 1,82,1
1,80,1 1,80,1 1,160,1 20,80,1 12,0,2 0,0,0 1,80,1 1,80,1 1,80,1
0,0,0 1,76,1 1,152,1 1,152,1 0,0,0 0,0,0 0,0,0 12,0,2 1,152,1
0,0,0 0,0,0 0,0,0 1,74,1 1,74,1 1,74,1 0,0,0 11,0,2 1,74,1
0,0,0 12,0,2 1,67,1 1,67,1 1,67,1 1,67,1 1,67,1 0,0,0 1,67,1
0,0,0 0,0,0 0,0,0 0,0,0 0,0,0 0,0,0 0,0,0 0,0,0 0,0,0
0,0,0 0,0,0 0,0,0 0,0,0 0,0,0 0,0,0 0,0,0 0,0,0 0,0,0
0,0,0 0,0,0 0,0,0 0,0,0 0,0,0 0,0,0 0,0,0 0,0,0 0,0,0