MODE 0
BALL 50
STARS 0/0/2345 35
ADDLINE 1,53,1 1,53,1 0,0,0 0,0,0 12,0,2 1,53,1 0,0,0 1,53,1 0,0,0
ADDLINE 1,54,1 1,54,1 10,0,2 1,54,1 0,0,0 1,54,1 1,54,1 1,54,1 12,0,2
ADDLINE 0,0,0 1,61,1 0,0,0 1,61,1 12,0,2 1,61,1 1,61,1 0,0,0 0,0,0
ADDLINE 1,59,1 1,59,1 1,59,1 1,59,1 12,0,2 1,59,1 0,0,0 1,59,1 1,59,1
ADDLINE 0,0,0 0,0,0 0,0,0 1,63,1 1,63,1 1,63,1 12,0,2 1,63,1 0,0,0
ADDLINE 0,0,0 1,44,1 1,44,1 1,44,1 1,44,1 1,44,1 12,0,2 1,44,1 0,0,0
1,60,1 0,0,0 12,0,2 0,0,0 0,0,0 0,0,0 0,0,0 1,60,1 1,60,1
1,62,1 12,0,2 1,62,1 1,62,1 0,0,0 1,62,1 6,62,1 1,62,1 1,62,1
1,60,1 12,0,2 1,60,1 1,60,1 0,0,0 0,0,0 1,60,1 1,60,1 1,60,1
1,59,1 0,0,0 1,59,1 1,59,1 1,59,1 0,0,0 0,0,0 12,0,2 1,59,1
1,116,1 12,0,2 16,58,1 1,116,1 1,116,1 1,116,1 0,0,0 1,116,1 1,116,1
1,53,1 12,0,2 1,53,1 1,53,1 1,53,1 1,53,1 1,53,1 1,53,1 1,53,1
0,0,0 0,0,0 0,0,0 0,0,0 0,0,0 0,0,0 0,0,0 0,0,0 0,0,0
0,0,0 0,0,0 0,0,0 0,0,0 0,0,0 0,0,0 0,0,0 0,0,0 0,0,0
0,0,0 0,0,0 0,0,0 0,0,0 0,0,0 0,0,0 0,0,0 0,0,0 0,0,0