MODE 0
BALL 50
STARS 0/0/2205 35
ADDLINE 1,48,1 1,48,1 1,48,1 1,48,1 1,48,1 1,48,1 2,48,1 12,0,2 5,48,1
ADDLINE 1,54,1 1,54,1 1,54,1 1,54,1 0,0,0 0,0,0 12,0,2 0,0,0 1,54,1
ADDLINE 1,61,1 0,0,0 0,0,0 0,0,0 12,0,2 1,61,1 1,61,1 0,0,0 1,61,1
ADDLINE 0,0,0 5,62,1 1,62,1 1,62,1 4,62,1 0,0,0 0,0,0 12,0,2 1,62,1
ADDLINE 0,0,0 1,63,1 1,63,1 1,63,1 1,63,1 1,63,1 12,0,2 0,0,0 1,63,1
ADDLINE 0,0,0 1,42,1 1,42,1 1,42,1 1,42,1 1,42,1 12,0,2 1,42,1 1,42,1
0,0,0 1,62,1 0,0,0 1,124,1 1,124,1 1,124,1 12,0,2 1,62,1 0,0,0
0,0,0 1,64,1 0,0,0 0,0,0 20,64,1 1,128,1 0,0,0 1,64,1 12,0,2
1,64,1 1,64,1 1,64,1 0,0,0 1,128,1 1,128,1 0,0,0 1,64,1 0,0,0
0,0,0 0,0,0 0,0,0 12,0,2 0,0,0 12,0,2 0,0,0 1,62,1 12,0,2
0,0,0 1,124,1 1,124,1 1,124,1 16,62,1 1,124,1 1,124,1 1,124,1 0,0,0
1,57,1 0,0,0 12,0,2 1,57,1 1,57,1 1,57,1 0,0,0 1,57,1 0,0,0
0,0,0 0,0,0 0,0,0 0,0,0 0,0,0 0,0,0 0,0,0 0,0,0 0,0,0
0,0,0 0,0,0 0,0,0 0,0,0 0,0,0 0,0,0 0,0,0 0,0,0 0,0,0
0,0,0 0,0,0 0,0,0 0,0,0 0,0,0 0,0,0 0,0,0 0,0,0 0,0,0