MODE 0
BALL 50
STARS 0/0/2205 35
ADDLINE 10,0,2 0,0,0 1,53,1 12,0,2 1,53,1 1,53,1 1,53,1 1,53,1 1,53,1
ADDLINE 1,51,1 1,51,1 1,51,1 12,0,2 0,0,0 1,51,1 3,51,1 1,51,1 1,51,1
ADDLINE 1,61,1 1,61,1 7,0,2 12,0,2 0,0,0 1,61,1 1,61,1 0,0,0 4,61,1
ADDLINE 1,56,1 1,56,1 12,0,2 1,56,1 1,56,1 1,56,1 2,56,1 1,56,1 1,56,1
ADDLINE 0,0,0 12,0,2 1,63,1 0,0,0 1,63,1 1,63,1 0,0,0 1,63,1 1,63,1
ADDLINE 1,44,1 0,0,0 1,44,1 12,0,2 0,0,0 5,44,1 0,0,0 1,44,1 0,0,0
0,0,0 1,66,1 1,66,1 1,66,1 12,0,2 1,66,1 1,66,1 1,66,1 0,0,0
0,0,0 6,66,1 0,0,0 1,66,1 12,0,2 6,66,1 0,0,0 1,66,1 0,0,0
0,0,0 1,66,1 0,0,0 0,0,0 12,0,2 1,66,1 0,0,0 0,0,0 0,0,0
0,0,0 1,66,1 1,66,1 1,66,1 12,0,2 1,66,1 1,66,1 1,66,1 0,0,0
0,0,0 1,66,1 0,0,0 6,66,1 12,0,2 1,66,1 0,0,0 6,66,1 0,0,0
0,0,0 1,66,1 1,66,1 1,66,1 12,0,2 1,66,1 1,66,1 1,66,1 0,0,0
0,0,0 0,0,0 0,0,0 0,0,0 0,0,0 0,0,0 0,0,0 0,0,0 0,0,0
0,0,0 0,0,0 0,0,0 0,0,0 0,0,0 0,0,0 0,0,0 0,0,0 0,0,0
0,0,0 0,0,0 0,0,0 0,0,0 0,0,0 0,0,0 0,0,0 0,0,0 0,0,0