MODE 0
BALL 50
STARS 0/0/2170 35
ADDLINE 0,0,0 1,53,1 1,53,1 4,53,1 0,0,0 2,53,1 12,0,2 1,53,1 1,53,1
ADDLINE 0,0,0 0,0,0 1,54,1 0,0,0 0,0,0 5,54,1 0,0,0 0,0,0 12,0,2
ADDLINE 3,58,1 1,58,1 6,58,1 2,58,1 1,58,1 1,58,1 12,0,2 1,58,1 0,0,0
ADDLINE 0,0,0 1,62,1 1,62,1 0,0,0 0,0,0 1,62,1 0,0,0 1,62,1 12,0,2
ADDLINE 0,0,0 3,63,1 4,63,1 1,63,1 12,0,2 1,63,1 1,63,1 5,63,1 0,0,0
ADDLINE 1,44,1 1,44,1 0,0,0 1,44,1 0,0,0 1,44,1 12,0,2 1,44,1 0,0,0
1,54,1 0,0,0 12,0,2 3,54,1 0,0,0 0,0,0 12,0,2 0,0,0 0,0,0
1,54,1 0,0,0 0,0,0 1,54,1 1,108,1 20,54,1 1,108,1 1,54,1 0,0,0
1,56,1 12,0,2 0,0,0 1,56,1 1,112,1 1,112,1 1,112,1 1,56,1 0,0,0
1,54,1 2,54,1 0,0,0 0,0,0 12,0,2 0,0,0 12,0,2 1,54,1 0,0,0
1,104,1 1,104,1 1,104,1 1,104,1 1,104,1 2,104,1 0,0,0 5,104,1 16,52,1
0,0,0 0,0,0 1,50,1 1,50,1 1,50,1 1,50,1 2,50,1 0,0,0 5,50,1
0,0,0 0,0,0 0,0,0 0,0,0 0,0,0 0,0,0 0,0,0 0,0,0 0,0,0
0,0,0 0,0,0 0,0,0 0,0,0 0,0,0 0,0,0 0,0,0 0,0,0 0,0,0
0,0,0 0,0,0 0,0,0 0,0,0 0,0,0 0,0,0 0,0,0 0,0,0 0,0,0