MODE 0
BALL 50
STARS 0/0/2135 35
ADDLINE 1,53,1 1,53,1 1,53,1 1,53,1 0,0,0 0,0,0 1,53,1 12,0,2 0,0,0
ADDLINE 0,0,0 1,51,1 12,0,2 2,51,1 5,51,1 1,51,1 1,51,1 1,51,1 5,51,1
ADDLINE 1,61,1 1,61,1 0,0,0 0,0,0 12,0,2 1,61,1 0,0,0 0,0,0 0,0,0
ADDLINE 1,59,1 1,59,1 1,59,1 1,59,1 0,0,0 1,59,1 1,59,1 1,59,1 12,0,2
ADDLINE 1,63,1 1,63,1 8,0,2 1,63,1 0,0,0 4,63,1 0,0,0 5,63,1 12,0,2
ADDLINE 0,0,0 5,44,1 0,0,0 1,44,1 1,44,1 2,44,1 12,0,2 1,44,1 1,44,1
0,0,0 0,0,0 0,0,0 3,62,1 0,0,0 2,62,1 1,62,1 1,62,1 12,0,2
1,61,1 12,0,2 1,61,1 1,61,1 0,0,0 1,61,1 9,0,2 1,61,1 1,61,1
1,60,1 0,0,0 0,0,0 0,0,0 12,0,2 5,60,1 1,60,1 1,60,1 4,60,1
0,0,0 12,0,2 0,0,0 1,59,1 3,59,1 2,59,1 0,0,0 0,0,0 0,0,0
0,0,0 1,116,1 16,58,1 1,116,1 1,116,1 4,116,1 2,116,1 12,0,2 0,0,0
1,57,1 0,0,0 1,57,1 12,0,2 1,57,1 0,0,0 1,57,1 0,0,0 0,0,0
0,0,0 0,0,0 0,0,0 0,0,0 0,0,0 0,0,0 0,0,0 0,0,0 0,0,0
0,0,0 0,0,0 0,0,0 0,0,0 0,0,0 0,0,0 0,0,0 0,0,0 0,0,0
0,0,0 0,0,0 0,0,0 0,0,0 0,0,0 0,0,0 0,0,0 0,0,0 0,0,0