MODE 0
BALL 50
STARS 0/0/2380 35
ADDLINE 1,48,1 1,48,1 2,48,1 1,48,1 3,48,1 1,48,1 12,0,2 1,48,1 1,48,1
ADDLINE 0,0,0 0,0,0 0,0,0 12,0,2 1,54,1 1,54,1 1,54,1 1,54,1 0,0,0
ADDLINE 0,0,0 1,61,1 1,61,1 1,61,1 1,61,1 20,61,1 1,61,1 16,61,1 12,0,2
ADDLINE 0,0,0 1,62,1 0,0,0 0,0,0 0,0,0 1,62,1 1,62,1 12,0,2 0,0,0
ADDLINE 1,63,1 1,63,1 0,0,0 1,63,1 12,0,2 2,63,1 1,63,1 3,63,1 0,0,0
ADDLINE 1,44,1 0,0,0 1,44,1 1,44,1 0,0,0 1,44,1 0,0,0 12,0,2 0,0,0
1,84,1 1,84,1 1,84,1 1,84,1 1,84,1 1,84,1 1,84,1 2,64,1 0,0,0
1,88,1 0,0,0 12,0,2 0,0,0 12,0,2 0,0,0 12,0,2 5,88,1 2,68,1
1,86,1 0,0,0 1,86,1 1,172,1 1,172,1 1,172,1 2,172,1 0,0,0 1,66,1
1,84,1 0,0,0 1,84,1 1,168,1 20,64,1 1,168,1 4,168,1 12,0,2 1,64,1
1,82,1 12,0,2 1,82,1 12,0,2 0,0,0 12,0,2 0,0,0 3,82,1 4,62,1
1,90,1 0,0,0 1,90,1 1,90,1 1,90,1 1,90,1 1,90,1 4,70,1 0,0,0
0,0,0 0,0,0 0,0,0 0,0,0 0,0,0 0,0,0 0,0,0 0,0,0 0,0,0
0,0,0 0,0,0 0,0,0 0,0,0 0,0,0 0,0,0 0,0,0 0,0,0 0,0,0
0,0,0 0,0,0 0,0,0 0,0,0 0,0,0 0,0,0 0,0,0 0,0,0 0,0,0