MODE 0
BALL 50
STARS 0/0/2135 35
ADDLINE 1,54,1 1,54,1 1,54,1 12,0,2 0,0,0 0,0,0 1,54,1 0,0,0 1,54,1
ADDLINE 0,0,0 0,0,0 0,0,0 12,0,2 1,55,1 0,0,0 1,55,1 0,0,0 1,55,1
ADDLINE 0,0,0 1,62,1 1,62,1 1,62,1 1,62,1 0,0,0 12,0,2 1,62,1 1,62,1
ADDLINE 1,63,1 1,63,1 1,63,1 12,0,2 0,0,0 0,0,0 1,63,1 1,63,1 1,63,1
ADDLINE 0,0,0 1,64,1 1,64,1 1,64,1 0,0,0 1,64,1 1,64,1 12,0,2 1,64,1
ADDLINE 0,0,0 12,0,2 1,45,1 1,45,1 0,0,0 1,45,1 1,45,1 0,0,0 1,45,1
0,0,0 1,70,1 1,70,1 1,140,1 1,140,1 1,140,1 1,70,1 1,70,1 0,0,0
1,72,1 1,72,1 12,0,2 1,144,1 20,72,1 1,144,1 12,0,2 1,72,1 1,72,1
1,74,1 10,0,2 0,0,0 0,0,0 0,0,0 0,0,0 0,0,0 10,0,2 1,74,1
1,72,1 1,72,1 1,72,1 1,72,1 12,0,2 1,72,1 1,72,1 1,72,1 1,72,1
0,0,0 1,72,1 0,0,0 1,72,1 0,0,0 1,72,1 0,0,0 1,72,1 0,0,0
0,0,0 1,70,1 12,0,2 1,70,1 11,0,2 1,70,1 12,0,2 1,70,1 0,0,0
0,0,0 0,0,0 0,0,0 0,0,0 0,0,0 0,0,0 0,0,0 0,0,0 0,0,0
0,0,0 0,0,0 0,0,0 0,0,0 0,0,0 0,0,0 0,0,0 0,0,0 0,0,0
0,0,0 0,0,0 0,0,0 0,0,0 0,0,0 0,0,0 0,0,0 0,0,0 0,0,0