MODE 0
BALL 50
STARS 0/0/2800 35
ADDLINE 1,54,1 0,0,0 0,0,0 12,0,2 1,54,1 0,0,0 1,54,1 0,0,0 1,54,1
ADDLINE 1,49,1 12,0,2 1,49,1 1,49,1 1,49,1 1,49,1 1,49,1 1,49,1 1,49,1
ADDLINE 10,0,2 12,0,2 1,62,1 0,0,0 0,0,0 0,0,0 1,62,1 0,0,0 1,62,1
ADDLINE 1,60,1 1,60,1 1,60,1 10,0,2 1,60,1 12,0,2 1,60,1 1,60,1 1,60,1
ADDLINE 0,0,0 0,0,0 1,64,1 12,0,2 1,64,1 0,0,0 1,64,1 0,0,0 0,0,0
ADDLINE 1,43,1 1,43,1 1,43,1 12,0,2 1,43,1 0,0,0 1,43,1 1,43,1 1,43,1
1,1,1 1,1,1 1,1,1 1,1,1 1,1,1 1,1,1 1,1,1 1,1,1 1,1,1
1,1,1 16,65,1 1,130,1 1,130,1 1,130,1 1,130,1 1,130,1 1,130,1 1,130,1
1,1,1 12,0,2 1,1,1 1,1,1 12,0,2 1,1,1 1,1,1 12,0,2 1,1,1
1,180,1 1,180,1 1,180,1 1,180,1 16,90,1 1,180,1 1,180,1 1,180,1 1,1,1
1,1,1 1,1,1 1,1,1 1,1,1 12,0,2 1,1,1 1,1,1 1,1,1 12,0,2
12,0,2 1,90,1 1,90,1 1,90,1 1,90,1 1,90,1 1,90,1 1,90,1 1,90,1
0,0,0 0,0,0 0,0,0 0,0,0 0,0,0 0,0,0 0,0,0 0,0,0 0,0,0
0,0,0 0,0,0 0,0,0 0,0,0 0,0,0 0,0,0 0,0,0 0,0,0 0,0,0
0,0,0 0,0,0 0,0,0 0,0,0 0,0,0 0,0,0 0,0,0 0,0,0 0,0,0