MODE 0
BALL 50
STARS 0/0/2135 35
ADDLINE 1,51,1 1,51,1 1,51,1 1,51,1 11,0,2 1,51,1 12,0,2 1,51,1 1,51,1
ADDLINE 0,0,0 1,55,1 0,0,0 0,0,0 0,0,0 1,55,1 12,0,2 1,55,1 0,0,0
ADDLINE 0,0,0 1,62,1 1,62,1 1,62,1 0,0,0 1,62,1 12,0,2 1,62,1 0,0,0
ADDLINE 1,63,1 1,63,1 0,0,0 1,63,1 0,0,0 1,63,1 1,63,1 1,63,1 12,0,2
ADDLINE 1,60,1 1,60,1 0,0,0 1,60,1 1,60,1 1,60,1 12,0,2 1,60,1 1,60,1
ADDLINE 0,0,0 1,50,1 12,0,2 1,50,1 1,50,1 0,0,0 0,0,0 1,50,1 1,50,1
0,0,0 1,58,1 1,58,1 0,0,0 0,0,0 12,0,2 1,58,1 1,58,1 1,58,1
1,60,1 1,60,1 12,0,2 0,0,0 1,60,1 0,0,0 0,0,0 1,60,1 1,60,1
1,62,1 12,0,2 0,0,0 1,62,1 0,0,0 1,62,1 0,0,0 0,0,0 1,62,1
1,64,1 0,0,0 5,64,1 0,0,0 1,64,1 12,0,2 1,64,1 0,0,0 1,64,1
1,60,1 0,0,0 11,0,2 1,60,1 12,0,2 1,60,1 0,0,0 2,60,1 0,0,0
1,58,1 1,58,1 0,0,0 0,0,0 1,58,1 1,58,1 1,58,1 12,0,2 0,0,0
0,0,0 0,0,0 0,0,0 0,0,0 0,0,0 0,0,0 0,0,0 0,0,0 0,0,0
0,0,0 0,0,0 0,0,0 0,0,0 0,0,0 0,0,0 0,0,0 0,0,0 0,0,0
0,0,0 0,0,0 0,0,0 0,0,0 0,0,0 0,0,0 0,0,0 0,0,0 0,0,0