MODE 0
BALL 50
STARS 0/0/2590 35
ADDLINE 1,54,1 0,0,0 1,54,1 12,0,2 1,54,1 1,54,1 1,54,1 0,0,0 1,54,1
ADDLINE 1,55,1 12,0,2 1,55,1 1,55,1 1,55,1 0,0,0 1,55,1 0,0,0 1,55,1
ADDLINE 1,62,1 1,62,1 1,62,1 0,0,0 1,62,1 12,0,2 1,62,1 0,0,0 1,62,1
ADDLINE 0,0,0 1,63,1 0,0,0 0,0,0 1,63,1 12,0,2 1,63,1 0,0,0 0,0,0
ADDLINE 1,57,1 1,57,1 1,57,1 1,57,1 1,57,1 12,0,2 1,57,1 1,57,1 1,57,1
ADDLINE 1,50,1 0,0,0 0,0,0 0,0,0 1,50,1 0,0,0 0,0,0 12,0,2 0,0,0
17,64,1 1,64,1 12,0,2 0,0,0 12,0,2 2,64,1 0,0,0 5,64,1 17,64,1
1,132,1 1,66,1 17,66,1 12,0,2 0,0,0 1,66,1 2,66,1 0,0,0 5,132,1
1,128,1 1,64,1 1,128,1 1,64,1 12,0,2 0,0,0 1,64,1 2,64,1 0,0,0
1,124,1 1,62,1 1,124,1 1,62,1 17,62,1 12,0,2 0,0,0 1,62,1 0,0,0
1,120,1 1,60,1 1,120,1 1,60,1 1,120,1 1,60,1 12,0,2 4,80,1 3,120,1
1,116,1 1,58,1 1,116,1 1,58,1 1,116,1 1,58,1 4,78,1 3,58,1 1,116,1
0,0,0 0,0,0 0,0,0 0,0,0 0,0,0 0,0,0 0,0,0 0,0,0 0,0,0
0,0,0 0,0,0 0,0,0 0,0,0 0,0,0 0,0,0 0,0,0 0,0,0 0,0,0
0,0,0 0,0,0 0,0,0 0,0,0 0,0,0 0,0,0 0,0,0 0,0,0 0,0,0