MODE 0
BALL 50
STARS 0/0/2450 35
ADDLINE 1,51,1 1,51,1 1,51,1 1,51,1 12,0,2 0,0,0 1,51,1 1,51,1 1,51,1
ADDLINE 1,55,1 1,55,1 1,55,1 0,0,0 0,0,0 1,55,1 12,0,2 0,0,0 1,55,1
ADDLINE 0,0,0 1,62,1 1,62,1 1,62,1 1,62,1 1,62,1 12,0,2 1,62,1 0,0,0
ADDLINE 0,0,0 12,0,2 1,63,1 1,63,1 1,63,1 1,63,1 16,63,1 1,63,1 1,63,1
ADDLINE 0,0,0 1,64,1 1,64,1 12,0,2 0,0,0 0,0,0 1,64,1 1,64,1 1,64,1
ADDLINE 1,50,1 0,0,0 0,0,0 1,50,1 1,50,1 0,0,0 12,0,2 1,50,1 1,50,1
4,80,1 3,80,1 1,160,1 1,160,1 1,160,1 1,160,1 1,160,1 2,80,1 5,80,1
0,0,0 1,82,1 17,82,1 1,164,1 17,82,1 1,164,1 17,82,1 1,82,1 0,0,0
0,0,0 4,84,1 12,0,2 0,0,0 0,0,0 0,0,0 12,0,2 5,84,1 0,0,0
0,0,0 3,82,1 2,164,1 12,0,2 12,0,2 12,0,2 3,164,1 2,82,1 0,0,0
0,0,0 1,80,1 1,160,1 17,80,1 12,0,2 17,80,1 1,160,1 1,80,1 0,0,0
0,0,0 1,78,1 1,156,1 1,156,1 1,156,1 1,156,1 1,156,1 1,78,1 0,0,0
0,0,0 0,0,0 0,0,0 0,0,0 0,0,0 0,0,0 0,0,0 0,0,0 0,0,0
0,0,0 0,0,0 0,0,0 0,0,0 0,0,0 0,0,0 0,0,0 0,0,0 0,0,0
0,0,0 0,0,0 0,0,0 0,0,0 0,0,0 0,0,0 0,0,0 0,0,0 0,0,0