MODE 0
BALL 50
STARS 0/0/2660 35
ADDLINE 0,0,0 1,54,1 1,54,1 0,0,0 12,0,2 1,54,1 3,54,1 0,0,0 1,54,1
ADDLINE 0,0,0 0,0,0 2,55,1 1,55,1 1,55,1 0,0,0 12,0,2 0,0,0 1,55,1
ADDLINE 5,62,1 0,0,0 1,62,1 1,62,1 1,62,1 12,0,2 0,0,0 1,62,1 0,0,0
ADDLINE 0,0,0 1,63,1 1,63,1 1,63,1 1,63,1 1,63,1 1,63,1 12,0,2 0,0,0
ADDLINE 5,64,1 0,0,0 1,64,1 1,64,1 1,64,1 1,64,1 12,0,2 0,0,0 1,64,1
ADDLINE 0,0,0 12,0,2 1,50,1 3,50,1 5,50,1 0,0,0 1,50,1 2,50,1 1,50,1
0,0,0 12,0,2 3,58,1 4,116,1 0,0,0 5,116,1 2,58,1 12,0,2 0,0,0
2,120,1 5,60,1 4,60,1 3,120,1 11,0,2 2,120,1 5,60,1 4,60,1 3,120,1
17,62,1 2,62,1 3,62,1 1,124,1 12,0,2 1,124,1 2,62,1 3,62,1 17,62,1
1,124,1 1,62,1 2,62,1 17,62,1 12,0,2 17,62,1 3,62,1 1,62,1 1,124,1
1,120,1 1,60,1 1,60,1 2,120,1 12,0,2 3,120,1 1,60,1 1,60,1 1,120,1
1,116,1 1,58,1 1,58,1 1,116,1 12,0,2 1,116,1 1,58,1 1,58,1 1,116,1
0,0,0 0,0,0 0,0,0 0,0,0 0,0,0 0,0,0 0,0,0 0,0,0 0,0,0
0,0,0 0,0,0 0,0,0 0,0,0 0,0,0 0,0,0 0,0,0 0,0,0 0,0,0
0,0,0 0,0,0 0,0,0 0,0,0 0,0,0 0,0,0 0,0,0 0,0,0 0,0,0