MODE 0
BALL 50
STARS 0/0/2135 35
ADDLINE 0,0,0 1,54,1 3,54,1 1,54,1 0,0,0 5,54,1 1,54,1 1,54,1 12,0,2
ADDLINE 0,0,0 1,55,1 0,0,0 1,55,1 12,0,2 1,55,1 0,0,0 0,0,0 0,0,0
ADDLINE 1,59,1 2,59,1 12,0,2 1,59,1 0,0,0 1,59,1 2,59,1 1,59,1 1,59,1
ADDLINE 1,63,1 5,63,1 0,0,0 4,63,1 1,63,1 1,63,1 0,0,0 1,63,1 12,0,2
ADDLINE 0,0,0 1,64,1 12,0,2 1,64,1 0,0,0 2,64,1 1,64,1 1,64,1 0,0,0
ADDLINE 0,0,0 1,50,1 0,0,0 1,50,1 12,0,2 1,50,1 0,0,0 0,0,0 1,50,1
4,58,1 0,0,0 0,0,0 0,0,0 0,0,0 0,0,0 0,0,0 0,0,0 12,0,2
12,0,2 3,62,1 17,62,1 0,0,0 17,62,1 0,0,0 17,62,1 2,62,1 0,0,0
12,0,2 1,64,1 0,0,0 0,0,0 0,0,0 0,0,0 0,0,0 1,64,1 0,0,0
12,0,2 1,62,1 4,124,1 5,62,1 4,124,1 5,62,1 4,124,1 5,62,1 0,0,0
12,0,2 1,60,1 2,120,1 3,60,1 2,120,1 3,60,1 2,120,1 3,60,1 0,0,0
12,0,2 5,58,1 1,116,1 1,58,1 1,116,1 1,58,1 1,116,1 4,58,1 3,58,1
0,0,0 0,0,0 0,0,0 0,0,0 0,0,0 0,0,0 0,0,0 0,0,0 0,0,0
0,0,0 0,0,0 0,0,0 0,0,0 0,0,0 0,0,0 0,0,0 0,0,0 0,0,0
0,0,0 0,0,0 0,0,0 0,0,0 0,0,0 0,0,0 0,0,0 0,0,0 0,0,0