MODE 0
BALL 50
STARS 0/0/2205 35
ADDLINE 1,54,1 0,0,0 1,54,1 12,0,2 1,54,1 16,54,1 1,54,1 8,0,2 1,54,1
ADDLINE 1,55,1 0,0,0 1,55,1 0,0,0 1,55,1 0,0,0 0,0,0 12,0,2 10,0,2
ADDLINE 1,59,1 12,0,2 1,59,1 1,59,1 1,59,1 0,0,0 5,59,1 1,59,1 1,59,1
ADDLINE 0,0,0 0,0,0 2,63,1 0,0,0 1,63,1 0,0,0 1,63,1 12,0,2 0,0,0
ADDLINE 1,60,1 1,60,1 1,60,1 12,0,2 1,60,1 1,60,1 1,60,1 10,0,2 1,60,1
ADDLINE 1,50,1 0,0,0 1,50,1 12,0,2 0,0,0 1,50,1 1,50,1 0,0,0 1,50,1
0,0,0 3,60,1 2,60,1 0,0,0 12,0,2 0,0,0 3,60,1 2,60,1 0,0,0
0,0,0 1,62,1 1,62,1 0,0,0 12,0,2 0,0,0 1,62,1 1,62,1 0,0,0
0,0,0 5,60,1 4,60,1 0,0,0 12,0,2 0,0,0 5,60,1 4,60,1 0,0,0
2,124,1 0,0,0 0,0,0 3,62,1 12,0,2 2,62,1 0,0,0 0,0,0 3,124,1
1,120,1 2,60,1 12,0,2 1,60,1 17,60,1 1,60,1 12,0,2 3,60,1 1,120,1
17,58,1 1,58,1 2,58,1 5,58,1 1,116,1 4,58,1 3,58,1 1,58,1 17,58,1
0,0,0 0,0,0 0,0,0 0,0,0 0,0,0 0,0,0 0,0,0 0,0,0 0,0,0
0,0,0 0,0,0 0,0,0 0,0,0 0,0,0 0,0,0 0,0,0 0,0,0 0,0,0
0,0,0 0,0,0 0,0,0 0,0,0 0,0,0 0,0,0 0,0,0 0,0,0 0,0,0