MODE 0
BALL 50
STARS 0/0/2065 35
ADDLINE 0,0,0 1,54,1 0,0,0 1,54,1 0,0,0 2,54,1 0,0,0 3,54,1 12,0,2
ADDLINE 0,0,0 1,55,1 0,0,0 1,55,1 1,55,1 4,55,1 0,0,0 1,55,1 12,0,2
ADDLINE 1,62,1 1,62,1 12,0,2 1,62,1 0,0,0 1,62,1 0,0,0 1,62,1 0,0,0
ADDLINE 1,57,1 1,57,1 1,57,1 1,57,1 12,0,2 2,57,1 1,57,1 1,57,1 1,57,1
ADDLINE 1,64,1 1,64,1 12,0,2 0,0,0 0,0,0 1,64,1 1,64,1 3,64,1 0,0,0
ADDLINE 0,0,0 1,50,1 0,0,0 1,50,1 5,50,1 1,50,1 0,0,0 3,50,1 12,0,2
0,0,0 17,60,1 0,0,0 0,0,0 12,0,2 0,0,0 0,0,0 1,120,1 2,60,1
1,62,1 1,124,1 17,62,1 0,0,0 1,62,1 12,0,2 0,0,0 17,62,1 1,62,1
1,64,1 1,128,1 1,128,1 0,0,0 0,0,0 12,0,2 0,0,0 1,128,1 4,64,1
1,62,1 1,124,1 1,124,1 0,0,0 1,62,1 12,0,2 0,0,0 0,0,0 0,0,0
0,0,0 1,120,1 1,120,1 2,60,1 12,0,2 0,0,0 0,0,0 0,0,0 1,60,1
0,0,0 1,116,1 1,116,1 1,58,1 1,58,1 1,58,1 0,0,0 12,0,2 0,0,0
0,0,0 0,0,0 0,0,0 0,0,0 0,0,0 0,0,0 0,0,0 0,0,0 0,0,0
0,0,0 0,0,0 0,0,0 0,0,0 0,0,0 0,0,0 0,0,0 0,0,0 0,0,0
0,0,0 0,0,0 0,0,0 0,0,0 0,0,0 0,0,0 0,0,0 0,0,0 0,0,0