MODE 0
BALL 50
STARS 0/400/800
0,0,0 1,40,1 1,8,1 1,8,1 1,8,1 1,8,1 1,8,1 1,40,1 0,0,0
12,0,2 1,40,1 0,0,0 0,0,0 1,8,1 0,0,0 0,0,0 1,40,1 12,0,2
0,0,0 1,40,1 0,0,0 0,0,0 1,8,1 0,0,0 0,0,0 1,40,1 0,0,0
12,0,2 1,40,1 0,0,0 0,0,0 1,8,1 0,0,0 0,0,0 1,40,1 12,0,2
0,0,0 1,40,1 0,0,0 0,0,0 1,8,1 0,0,0 0,0,0 1,40,1 0,0,0
12,0,2 1,40,1 1,8,1 1,8,1 1,8,1 1,8,1 1,8,1 1,40,1 12,0,2
0,0,0 0,0,0 0,0,0 0,0,0 0,0,0 0,0,0 0,0,0 0,0,0 0,0,0
0,0,0 0,0,0 0,0,0 0,0,0 0,0,0 0,0,0 0,0,0 0,0,0 0,0,0
0,0,0 0,0,0 0,0,0 0,0,0 0,0,0 0,0,0 0,0,0 0,0,0 0,0,0