MODE 0
BALL 50
STARS 0/400/800
1,40,1 1,40,1 1,40,1 0,0,0 0,0,0 1,40,1 1,40,1 1,50,1 0,0,0
1,40,1 0,0,0 1,30,1 0,0,0 0,0,0 1,40,1 0,0,0 1,50,1 12,0,2
1,40,1 0,0,0 1,30,1 0,0,0 0,0,0 1,40,1 0,0,0 1,50,1 0,0,0
1,40,1 0,0,0 1,30,1 0,0,0 0,0,0 1,40,1 0,0,0 1,50,1 12,0,2
1,40,1 0,0,0 0,0,0 0,0,0 0,0,0 0,0,0 0,0,0 1,50,1 0,0,0
1,40,1 1,40,1 1,40,1 1,40,1 1,50,1 1,50,1 1,50,1 1,50,1 12,0,2
5,1,1 4,1,1 5,1,1 4,1,1 5,1,1 4,1,1 5,1,1 4,1,1 0,0,0
0,0,0 0,0,0 0,0,0 0,0,0 0,0,0 0,0,0 0,0,0 0,0,0 0,0,0
0,0,0 0,0,0 0,0,0 0,0,0 0,0,0 0,0,0 0,0,0 0,0,0 0,0,0